A Treehouse Beneath The Cliff
An Interactive Fiction by FIGBERT
Release 1 / Serial number 200701 / Inform 7 build 6M62 (I6/v6.34 lib 6/12N) SD

Plateau
You awake to find youself prone on the ground. You look around to see a grassy field that seems to stretch on forever in all directions, ending abruptly half a meter south of you. You scramble quickly away from the edge. You look around and see an endless landscape of grass, flat for kilometers in all directions except south, where it ends in an sudden dropoff.

>Go through the cliff
Desert
A sandy expanse streatching out southward, ending abruptly to the north in a smooth cliff-face.

* * *

A Treehouse Beneath The Cliff
An Interactive Fiction by FIGBERT
Release 1 / Serial number 200701 / Inform 7 build 6M62 (I6/v6.34 lib 6/12N) SD

Plateau
You awake to find youself prone on the ground. You look around to see a grassy field that seems to stretch on forever in all directions, ending abruptly half a meter south of you. You scramble quickly away from the edge. You look around and see an endless landscape of grass, flat for kilometers in all directions except south, where it ends in an sudden dropoff.

>climb down
You must name something more substantial.

>climb down the cliff
I only understood you as far as wanting to climb down.

>climb down cliff
I only understood you as far as wanting to climb down.

>climb cliff
Little is to be achieved by that.

* * *

A Treehouse Beneath The Cliff
An Interactive Fiction by FIGBERT
Release 1 / Serial number 200701 / Inform 7 build 6M62 (I6/v6.34 lib 6/12N) SD

Plateau
You awake to find youself prone on the ground. You look around to see a grassy field that seems to stretch on forever in all directions, ending abruptly half a meter south of you. You scramble quickly away from the edge. You look around and see an endless landscape of grass, flat for kilometers in all directions except south, where it ends in an sudden dropoff.

>go cliff
Desert
A sandy expanse streatching out southward, ending abruptly to the north in a smooth cliff-face.

>go north
You can't go that way.

>exit
But you aren't in anything at the moment.

* * *

A Treehouse Beneath The Cliff
An Interactive Fiction by FIGBERT
Release 1 / Serial number 200701 / Inform 7 build 6M62 (I6/v6.34 lib 6/12N) SD

Plateau
You awake to find youself prone on the ground. You look around to see a grassy field that seems to stretch on forever in all directions, ending abruptly half a meter south of you. You scramble quickly away from the edge. You look around and see an endless landscape of grass, flat for kilometers in all directions except south, where it ends in an sudden dropoff.

>go down
Desert
You leap out from the grassy plateau and fall downwards through the air, hitting the sand with a resounding thump. You find yourself in a sandy expanse stretching out southward, ending abruptly to the north in a smooth cliff-face.

>go up
You can't go that way.

>go north
You can't go that way.

>go west
You can't go that way.

>go east
You can't go that way.

>go south
You can't go that way.

* * *

A Treehouse Beneath The Cliff
An Interactive Fiction by FIGBERT
Release 1 / Serial number 200701 / Inform 7 build 6M62 (I6/v6.34 lib 6/12N) SD

Plateau
You awake to find youself prone on the ground. You look around to see a grassy field that seems to stretch on forever in all directions, ending abruptly half a meter south of you. You scramble quickly away from the edge. You look around and see an endless landscape of grass, flat for kilometers in all directions except south, where it ends in an sudden dropoff.

>go n
You can't go that way.

>look
Plateau
An endless landscape of grass, flat for kilometers in all directions except south, where it ends in an sudden dropoff.

* * *

A Treehouse Beneath The Cliff
An Interactive Fiction by FIGBERT
Release 1 / Serial number 200701 / Inform 7 build 6M62 (I6/v6.34 lib 6/12N) SD

Plateau
You awake to find youself prone on the ground. You look around to see a grassy field that seems to stretch on forever in all directions, ending abruptly half a meter south of you. You scramble quickly away from the edge. You look around and see an endless landscape of grass, flat for kilometers in all directions except south, where it ends in an sudden dropoff.

>go north
Poop
Poop town

>go south
Plateau
An endless landscape of grass, flat for kilometers in all directions except south, where it ends in an sudden dropoff.

You can see a cliff here.

* * *

>go north
Poop
Poop town

>north
You can't go that way.

>south
You can't go that way.

>east
You can't go that way.

>west
You can't go that way.

* * *

A Treehouse Beneath The Cliff
An Interactive Fiction by FIGBERT
Release 1 / Serial number 200701 / Inform 7 build 6M62 (I6/v6.34 lib 6/12N) SD

Plateau
You awake to find youself prone on the ground. You look around to see a grassy field that seems to stretch on forever in all directions, ending abruptly half a meter south of you. You scramble quickly away from the edge. You look around and see an endless landscape of grass, flat for kilometers in all directions except south, where it ends in an sudden dropoff.

>go south
Desert
You leap out from the grassy plateau and fall downwards through the air, hitting the sand with a resounding thump. You find yourself in a sandy expanse stretching out southward, ending abruptly to the north in a smooth cliff-face.

>go nort
You can't see any such thing.

>go north
You can't go that way.

* * *

>go south
Desert
You leap out from the grassy plateau and fall downwards through the air, hitting the sand with a resounding thump. You find yourself in a sandy expanse stretching out southward, ending abruptly to the north in a smooth cliff-face.

>go north
You can't go that way.

>go south
Tree in the Desert
An ancient, gnarled tree stands alone in the sands bleached white by the heat of the sun. Hanging from the one of the highest branches is a ladder dangling just above you.

>go up
The ladder is high above the ground, but if you jump maybe you can grab it.

>climb the ladder
The ladder is high above the ground, but if you jump maybe you can grab it.

* * *

>go north
You can't go that way.

>go u
Jumping down into the sand is one thing: climbing this is another. You reach for a handhold, but wind and sand have worn the cliff face smooth to the touch.

>go up
Jumping down into the sand is one thing: climbing this is another. You reach for a handhold, but wind and sand have worn the cliff face smooth to the touch.

* * *

>go north
You can't go that way.

>look
Desert
A sandy expanse stretching out southward, ending abruptly to the north in a smooth cliff-face.

>look north
You make out the Plateau that way.

>look west
You can't see anything promising that way.

* * *

>go south
Desert
You leap out from the grassy plateau and fall downwards through the air, hitting the sand with a resounding thump. You find yourself in a sandy expanse stretching out southward, ending abruptly to the north in a smooth cliff-face.

>go south
Tree in the Desert
An ancient, gnarled tree stands alone in the sands bleached white by the heat of the sun. Hanging from the one of the highest branches is a ladder dangling just above you.

>go north
Desert
A sandy expanse stretching out southward, ending abruptly to the north in a smooth cliff-face.

* * *

>go south
Tree in the Desert
An ancient, gnarled tree stands alone in the sands bleached white by the heat of the sun. Hanging from the one of the highest branches is a ladder dangling just above you.

>jump
You start your jump up towards the ladder, but the pressure you put on your foot before jumping causes the sand to shif as you begin your jump and you miss the ladder.

>open pouch
You can't see any such thing.

>jump
You start your jump up towards the ladder, but the pressure you put on your foot before jumping causes the sand to shif as you begin your jump and you miss the ladder.

>jump
You start your jump up towards the ladder, but the pressure you put on your foot before jumping causes the sand to shif as you begin your jump and you miss the ladder.

>jump
You flex your legs and jump with all your might, and you manage to catch the final rung of the latter. You pull yourself up the rungs one-by-one, and collapse on the platform.

Treehouse
You straighten yourself up, and look around the platform.The treehouse is less of a house and more of a platform, built of warped branches washed as white as the rest of the tree. On the far side of the platform is a leather pouch.

>open pouch
You open leather pouch, revealing a brass lamp.

>take lamp
Taken.

* * *

>go south
Tree in the Desert
An ancient, gnarled tree stands alone in the sands bleached white by the heat of the sun. Hanging from the one of the highest branches is a ladder dangling just above you.

>look at ladder
That noun did not make sense in this context.

* * *

>go south
Tree in the Desert
An ancient, gnarled tree stands alone in the sands bleached white by the heat of the sun. Hanging from the one of the highest branches is a ladder dangling just above you.

>look north
You look back and find yourself confronted by the cliff you just jumped from. Does it seem taller than it did when you were on top?

>look west
The sandy expanse stretches on past the horizon.

>look south
The sandy expanse stretches on past the horizon.

>look east
The sandy expanse stretches on past the horizon.

>look up
You see a rope ladder connected by sturdy white branches, apparently from the tree itself. It hangs from high up in the tree, and ends 2 meters above the ground.

>go up
The ladder is high above the ground, but if you jump maybe you can grab it.

* * *

>climb the ladder
The ladder is high above the ground, but if you jump maybe you can grab it.

>jump
You flex your legs and jump with all your might, and you manage to catch the final rung of the latter. You pull yourself up the rungs one-by-one, and collapse on the platform.

Treehouse
You straighten yourself up, and look around the platform.

>jump
You jump on the spot.

>jump
You jump on the spot.

>look
Treehouse

* * *

>go south
Desert
You leap out from the grassy plateau and fall downwards through the air, hitting the sand with a resounding thump. You find yourself in a sandy expanse stretching out southward, ending abruptly to the north in a smooth cliff-face.

>look
of the Desert
A sandy expanse stretching out southward, ending abruptly to the north in a smooth cliff-face.

* * *

>go south
Desert
You leap out from the grassy plateau and fall downwards through the air, hitting the sand with a resounding thump. You find yourself in a sandy expanse stretching out southward, ending abruptly to the north in a smooth cliff-face.

>look north
You look back and find yourself confronted by the cliff you just jumped from. Does it seem taller than it did when you were on top?

>go north
Jumping down into the sand is one thing: climbing this is another. You reach for a handhold, but wind and sand have worn the cliff face smooth to the touch.

>look west
The sandy expanse stretches on past the horizon.

>look east
The sandy expanse stretches on past the horizon.

>look south
You make out Tree in the Desert that way.

* * *

>look north
You look back and find yourself confronted by the cliff you just jumped from. Does it seem taller than it did when you were on top?

>look up
You look back and find yourself confronted by the cliff you just jumped from. Does it seem taller than it did when you were on top?

>go north
Jumping down into the sand is one thing: climbing this is another. You reach for a handhold, but wind and sand have worn the cliff face smooth to the touch.

>go up
Jumping down into the sand is one thing: climbing this is another. You reach for a handhold, but wind and sand have worn the cliff face smooth to the touch.

>go east
You can't go that way.

>go west
You can't go that way.

>go south
Tree in the Desert
An ancient, gnarled tree stands alone in the sands bleached white by the heat of the sun. Hanging from the one of the highest branches is a ladder dangling just above you.

>look north
A sandy expanse stretching out southward, ending abruptly to the north in a smooth cliff-face.

>go north
Desert
A sandy expanse stretching out southward, ending abruptly to the north in a smooth cliff-face.

>go south
Tree in the Desert
An ancient, gnarled tree stands alone in the sands bleached white by the heat of the sun. Hanging from the one of the highest branches is a ladder dangling just above you.

>look south
You can't see anything promising that way.

>look west
You can't see anything promising that way.

>look east
You can't see anything promising that way.

>look north
A sandy expanse stretching out southward, ending abruptly to the north in a smooth cliff-face.

>look up
You straighten yourself up, and look around the platform.

* * *

>go south
Desert
You leap out from the grassy plateau and fall downwards through the air, hitting the sand with a resounding thump. You find yourself in a sandy expanse stretching out southward, ending abruptly to the north in a smooth cliff-face.

>south
Tree in the Desert
An ancient, gnarled tree stands alone in the sands bleached white by the heat of the sun. Hanging from the one of the highest branches is a ladder dangling just above you.

>climb up
You must name something more substantial.

>climb the ladder
The ladder is high above the ground, but if you jump maybe you can grab it.

>go up[
You can't see any such thing.

>go up\
You can't see any such thing.

>go up
The ladder is high above the ground, but if you jump maybe you can grab it.

>jump
You flex your legs and jump with all your might, and you manage to catch the final rung of the latter. You pull yourself up the rungs one-by-one, and collapse on the platform.

Treehouse
A house in a tree.

>go down
Tree in the Desert
An ancient, gnarled tree stands alone in the sands bleached white by the heat of the sun. Hanging from the one of the highest branches is a ladder dangling just above you.

>jump
You flex your legs and jump with all your might, and you manage to catch the final rung of the latter. You pull yourself up the rungs one-by-one, and collapse on the platform.

Treehouse
A house in a tree.

>jump
You jump on the spot.

>go down
Tree in the Desert
An ancient, gnarled tree stands alone in the sands bleached white by the heat of the sun. Hanging from the one of the highest branches is a ladder dangling just above you.

* * *

>south
Tree in the Desert
An ancient, gnarled tree stands alone in the sands bleached white by the heat of the sun. Hanging from the one of the highest branches is a ladder dangling just above you.

>jump
You flex your legs and jump with all your might, and you manage to catch the final rung of the latter. You pull yourself up the rungs one-by-one, and collapse on the platform.

Treehouse
A house in a tree.

* * *

A Treehouse Beneath The Cliff
An Interactive Fiction by FIGBERT
Release 1 / Serial number 200701 / Inform 7 build 6M62 (I6/v6.34 lib 6/12N) SD

Plateau
You awake to find youself prone on the ground. You look around to see a grassy field that seems to stretch on forever in all directions, ending abruptly half a meter south of you. You scramble quickly away from the edge. You look around and see an endless landscape of grass, flat for kilometers in all directions except south, where it ends in an sudden dropoff.

>go to the cliff
You can't see any such thing.

>go cliff
desert
A sandy expanse streatching out southward, ending abruptly to the north in a smooth cliff-face.

* * *

A Treehouse Beneath The Cliff
An Interactive Fiction by FIGBERT
Release 1 / Serial number 200701 / Inform 7 build 6M62 (I6/v6.34 lib 6/12N) SD

Plateau
You awake to find youself prone on the ground. You look around to see a grassy field that seems to stretch on forever in all directions, ending abruptly half a meter south of you. You scramble quickly away from the edge. You look around and see an endless landscape of grass, flat for kilometers in all directions except south, where it ends in an sudden dropoff.

>jump
Desert
A sandy expanse streatching out southward, ending abruptly to the north in a smooth cliff-face.

>jump
You can't go that way.

* * *

A Treehouse Beneath The Cliff
An Interactive Fiction by FIGBERT
Release 1 / Serial number 200701 / Inform 7 build 6M62 (I6/v6.34 lib 6/12N) SD

Plateau
You awake to find youself prone on the ground. You look around to see a grassy field that seems to stretch on forever in all directions, ending abruptly half a meter south of you. You scramble quickly away from the edge. You look around and see an endless landscape of grass, flat for kilometers in all directions except south, where it ends in an sudden dropoff.

>look
Plateau
An endless landscape of grass, flat for kilometers in all directions except south, where it ends in an sudden dropoff.

>go south
Desert
You leap out from the grassy plateau and fall downwards through the air, hitting the sand with a resounding thump. You find yourself in a sandy expanse stretching out southward, ending abruptly to the north in a smooth cliff-face.

* * *

>go up
The ladder is high above the ground, but if you jump maybe you can grab it.

>climb
(the ladder)
Little is to be achieved by that.

>look
Tree in the Desert
An ancient, gnarled tree stands alone in the sands bleached white by the heat of the sun. Hanging from the one of the highest branches is a ladder dangling just above you.

>climb the ladder
Little is to be achieved by that.

* * *

A Treehouse Beneath The Cliff
An Interactive Fiction by FIGBERT
Release 1 / Serial number 200701 / Inform 7 build 6M62 (I6/v6.34 lib 6/12N) SD

Plateau
You awake to find youself prone on the ground. You look around to see a grassy field that seems to stretch on forever in all directions, ending abruptly half a meter south of you. You scramble quickly away from the edge. You look around and see an endless landscape of grass, flat for kilometers in all directions except south, where it ends in an sudden dropoff.

>look at Desert
That noun did not make sense in this context.

>look south
Peering over the cliff, you see a sandy expanse perhaps 5 meters below you. Maybe it's a soft landing?

>s
Desert
You leap out from the grassy plateau and fall downwards through the air, hitting the sand with a resounding thump. You find yourself in a sandy expanse stretching out southward, ending abruptly to the north in a smooth cliff-face.

>s
Tree in the Desert
An ancient, gnarled tree stands alone in the sands bleached white by the heat of the sun. Hanging from the one of the highest branches is a ladder dangling just above you.

>look at ladder
A rope ladder connected by sturdy white branches, apparently from the tree itself. It hangs from high up in the tree, and ends 2 meters above the ground.

>look toward ladder
That noun did not make sense in this context.

* * *

A Treehouse Beneath The Cliff
An Interactive Fiction by FIGBERT
Release 1 / Serial number 200701 / Inform 7 build 6M62 (I6/v6.34 lib 6/12N) SD

Plateau
You awake to find youself prone on the ground. You look around to see a grassy field that seems to stretch on forever in all directions, ending abruptly half a meter south of you. You scramble quickly away from the edge. You look around and see an endless landscape of grass, flat for kilometers in all directions except south, where it ends in an sudden dropoff.

>look at cliff
Peering over the cliff, you see a sandy expanse perhaps 5 meters below you. Maybe it's a soft landing?

>examine cliff
Peering over the cliff, you see a sandy expanse perhaps 5 meters below you. Maybe it's a soft landing?

>look south
Peering over the cliff, you see a sandy expanse perhaps 5 meters below you. Maybe it's a soft landing?

* * *

A Treehouse Beneath The Cliff
An Interactive Fiction by FIGBERT
Release 1 / Serial number 200701 / Inform 7 build 6M62 (I6/v6.34 lib 6/12N) SD

Plateau
You awake to find youself prone on the ground. You look around to see a grassy field that seems to stretch on forever in all directions, ending abruptly half a meter south of you. You scramble quickly away from the edge. You look around and see an endless landscape of grass, flat for kilometers in all directions except south, where it ends in an sudden dropoff.

>look at the cliff
Peering over the cliff, you see a sandy expanse maybe 5 meters below you. Maybe it's a soft landing?

>go through the cliff
Desert
A sandy expanse streatching out southward, ending abruptly to the north in a smooth cliff-face.

>go through the cliff
You can't see any such thing.

>go north
You can't go that way.

* * *

>look at the cliff
Peering over the cliff, you see a sandy expanse maybe 5 meters below you. Maybe it's a soft landing?

>jump
You jump on the spot.

>jump down
I only understood you as far as wanting to jump.

* * *

>look at the cliff
Peering over the cliff, you see a sandy expanse maybe 5 meters below you. Maybe it's a soft landing?

>jump down
I only understood you as far as wanting to jump.

>go south
Desert
A sandy expanse streatching out southward, ending abruptly to the north in a smooth cliff-face.

>go north
You can't go that way.

>look north
You see nothing unexpected in that direction.

* * *

>look at the cliff
Peering over the cliff, you see a sandy expanse maybe 5 meters below you. Maybe it's a soft landing?

>look at the desert
That noun did not make sense in this context.

>look at the Desert
That noun did not make sense in this context.

>look Desert
That noun did not make sense in this context.

>look south
You make out the Desert that way.

>look toward the Desert
That noun did not make sense in this context.

* * *

>look at the cliff
Peering over the cliff, you see a sandy expanse maybe 5 meters below you. Maybe it's a soft landing?

>look through the cliff
You find nothing of interest.

* * *

A Treehouse Beneath The Cliff
An Interactive Fiction by FIGBERT
Release 1 / Serial number 200701 / Inform 7 build 6M62 (I6/v6.34 lib 6/12N) SD

Plateau
You awake to find youself prone on the ground. You look around to see a grassy field that seems to stretch on forever in all directions, ending abruptly half a meter south of you. You scramble quickly away from the edge. You look around and see an endless landscape of grass, flat for kilometers in all directions except south, where it ends in an sudden dropoff.

>look below the plateau
You can't see any such thing.

>look at the desert
You can't see any such thing.

>look
Plateau
An endless landscape of grass, flat for kilometers in all directions except south, where it ends in an sudden dropoff.

* * *

A Treehouse Beneath The Cliff
An Interactive Fiction by FIGBERT
Release 1 / Serial number 200701 / Inform 7 build 6M62 (I6/v6.34 lib 6/12N) SD

Plateau
You awake to find youself prone on the ground. You look around to see a grassy field that seems to stretch on forever in all directions, ending abruptly half a meter south of you. You scramble quickly away from the edge. You look around and see an endless landscape of grass, flat for kilometers in all directions except south, where it ends in an sudden dropoff.

>look down
Peering over the cliff, you see a sandy expanse perhaps 5 meters below you. Maybe it's a soft landing?

>look south
Peering over the cliff, you see a sandy expanse perhaps 5 meters below you. Maybe it's a soft landing?

>go south
Desert
You leap out from the grassy plateau and fall downwards through the air, hitting the sand with a resounding thump. You find yourself in a sandy expanse stretching out southward, ending abruptly to the north in a smooth cliff-face.

>look north
You look north and find yourself confronted by the cliff you just jumped from. Does it seem taller than it did when you were on top?

>look up
You look north and find yourself confronted by the cliff you just jumped from. Does it seem taller than it did when you were on top?

* * *

A Treehouse Beneath The Cliff
An Interactive Fiction by FIGBERT
Release 1 / Serial number 200701 / Inform 7 build 6M62 (I6/v6.34 lib 6/12N) SD

Plateau
You awake to find youself prone on the ground. You look around to see a grassy field that seems to stretch on forever in all directions, ending abruptly half a meter south of you. You scramble quickly away from the edge. You look around and see an endless landscape of grass, flat for kilometers in all directions except south, where it ends in an sudden dropoff.

>look n
The green grass field stretches on past the horizon.

>look w
The green grass field stretches on past the horizon.

>look e
The green grass field stretches on past the horizon.

>look s
Peering over the cliff, you see a sandy expanse perhaps 5 meters below you. Maybe it's a soft landing?

>look at cliff
Peering over the cliff, you see a sandy expanse perhaps 5 meters below you. Maybe it's a soft landing?

>go s
Desert
You leap out from the grassy plateau and fall downwards through the air, hitting the sand with a resounding thump. You find yourself in a sandy expanse stretching out southward, ending abruptly to the north in a smooth cliff-face.

>look
Desert
A sandy expanse stretching out southward, ending abruptly to the north in a smooth cliff-face.

>look w
The sandy expanse stretches on past the horizon.

>look e
The sandy expanse stretches on past the horizon.

>look n
You look north and find yourself confronted by the cliff you just jumped from. Does it seem taller than it did when you were on top?

>look s
Looking south, you see a giant tree bleached white by the sun. Hanging from its branches is a ladder, and at the top is a platform.

* * *

A Treehouse Beneath The Cliff
An Interactive Fiction by FIGBERT
Release 1 / Serial number 200701 / Inform 7 build 6M62 (I6/v6.34 lib 6/12N) SD

Plateau
You awake to find youself prone on the ground. You look around to see a grassy field that seems to stretch on forever in all directions, ending abruptly half a meter south of you. You scramble quickly away from the edge. You look around and see an endless landscape of grass, flat for kilometers in all directions except south, where it ends in an sudden dropoff.

>look north
The green grass field stretches on past the horizon.

>go north
Test
fuck

You can see a cat here.

* * *

>look north
The green grass field stretches on past the horizon.

>look east
The green grass field stretches on past the horizon.

>look west
The green grass field stretches on past the horizon.

>look south
You make out the Desert that way.

* * *

>look north
The green grass field stretches on past the horizon.

>look south
Peering over the cliff, you see a sandy expanse perhaps 5 meters below you. Maybe it's a soft landing?

>look west
The green grass field stretches on past the horizon.

>look east
The green grass field stretches on past the horizon.

>go south
Desert
You leap out from the grassy plateau and fall downwards through the air, hitting the sand with a resounding thump. You find yourself in a sandy expanse stretching out southward, ending abruptly to the north in a smooth cliff-face.

* * *

>look north
You look north and find yourself confronted by the cliff you just jumped from. Does it seem taller than it did when you were on top?

>look west
The sandy expanse stretches on past the horizon.

* * *

>look east
The sandy expanse stretches on past the horizon.

>look south
Looking south, you see a giant tree bleached white by the sun. Hanging from its branches is a ladder, and at the top is a platform.

>go south
Tree in the Desert
An ancient, gnarled tree stands alone in the sands bleached white by the heat of the sun. Hanging from the one of the highest branches is a ladder dangling just above you.

>look at ladder
The ladder is high above the ground, but if you jump maybe you can grab it.

>look at desert
You make out a Desert that way.

>go up
The ladder is high above the ground, but if you jump maybe you can grab it.

>look
Tree in the Desert
An ancient, gnarled tree stands alone in the sands bleached white by the heat of the sun. Hanging from the one of the highest branches is a ladder dangling just above you.

>climb
What do you want to climb?

>climb up
You must name something more substantial.

>climb ladder
You can't see any such thing.

* * *

>look north
The green grass field stretches on past the horizon.

>look west
The green grass field stretches on past the horizon.

* * *

>look east
The green grass field stretches on past the horizon.

>look south
You make out the Desert that way.

>go south
Desert
You leap out from the grassy plateau and fall downwards through the air, hitting the sand with a resounding thump. You find yourself in a sandy expanse stretching out southward, ending abruptly to the north in a smooth cliff-face.

>go north
Jumping down into the sand is one thing: climbing this is another. You reach for a handhold, but wind and sand have worn the cliff face smooth to the touch.

>look north
The sandy expanse stretches on past the horizon.

* * *

A Treehouse Beneath The Cliff
An Interactive Fiction by FIGBERT
Release 1 / Serial number 200701 / Inform 7 build 6M62 (I6/v6.34 lib 6/12N) SD

Plateau
You awake to find youself prone on the ground. You look around to see a grassy field that seems to stretch on forever in all directions, ending abruptly half a meter south of you. You scramble quickly away from the edge. You look around and see an endless landscape of grass, flat for kilometers in all directions except south, where it ends in an sudden dropoff.

>look s
You see nothing unexpected in that direction.

* * *

A Treehouse Beneath The Cliff
An Interactive Fiction by FIGBERT
Release 1 / Serial number 200701 / Inform 7 build 6M62 (I6/v6.34 lib 6/12N) SD

Plateau
You awake to find youself prone on the ground. You look around to see a grassy field that seems to stretch on forever in all directions, ending abruptly half a meter south of you. You scramble quickly away from the edge. You look around and see an endless landscape of grass, flat for kilometers in all directions except south, where it ends in an sudden dropoff.

>look south
Peering over the cliff, you see a sandy expanse perhaps 5 meters below you. Maybe it's a soft landing?

* * *

>go north
You can't go that way.

>go up
Jumping down into the sand is one thing: climbing this is another. You reach for a handhold, but wind and sand have worn the cliff face smooth to the touch.

>look nort
That noun did not make sense in this context.

>look nortj
That noun did not make sense in this context.

>look north
You look north and find yourself confronted by the cliff you just jumped from. Does it seem taller than it did when you were on top?

>look up
The sandy expanse stretches on past the horizon.

* * *

>go south
Desert
You leap out from the grassy plateau and fall downwards through the air, hitting the sand with a resounding thump. You find yourself in a sandy expanse stretching out southward, ending abruptly to the north in a smooth cliff-face.

>look west
You see nothing unexpected in that direction.

>look east
You see nothing unexpected in that direction.

* * *

>Above the desert is nowhere. North of the desert is nothing.
That's not a verb I recognise.

* * *

>look south
Peering over the cliff, you see a sandy expanse perhaps 5 meters below you. Maybe it's a soft landing?

>look at cliff
Peering over the cliff, you see a sandy expanse perhaps 5 meters below you. Maybe it's a soft landing?

>look nort
That noun did not make sense in this context.

>look north
The green grass field stretches on past the horizon.

* * *

>go south
Desert
You leap out from the grassy plateau and fall downwards through the air, hitting the sand with a resounding thump. You find yourself in a sandy expanse stretching out southward, ending abruptly to the north in a smooth cliff-face.

>look nort
That noun did not make sense in this context.

>look north
You look north and find yourself confronted by the cliff you just jumped from. Does it seem taller than it did when you were on top?

>l e
The sandy expanse stretches on past the horizon.

>l w
The sandy expanse stretches on past the horizon.

>l s
Look south, you see a giant tree bleached white by the sun.

>go s
Tree in the Desert
An ancient, gnarled tree stands alone in the sands bleached white by the heat of the sun. Hanging from the one of the highest branches is a ladder dangling just above you.

* * *

>look south
Peering over the cliff, you see a sandy expanse perhaps 5 meters below you. Maybe it's a soft landing?

>look below
You can't see any such thing.

>look down
You see nothing unexpected in that direction.

>go down
Desert
There's sand here I guess.

>go up
Plateau
An endless landscape of grass, flat for kilometers in all directions except south, where it ends in an sudden dropoff.

>go down
Desert
There's sand here I guess.

* * *

>go up
Plateau
An endless landscape of grass, flat for kilometers in all directions except south, where it ends in an sudden dropoff.

>go south
Desert
There's sand here I guess.

* * *

>look south
Peering over the cliff, you see a sandy expanse perhaps 5 meters below you. Maybe it's a soft landing?

>look down
The green grass field stretches on past the horizon.

* * *

>look south
Peering over the cliff, you see a sandy expanse perhaps 5 meters below you. Maybe it's a soft landing?

>look north
The green grass field stretches on past the horizon.

>go south
Desert
You leap out from the grassy plateau and fall downwards through the air, hitting the sand with a resounding thump. You find yourself in a sandy expanse stretching out southward, ending abruptly to the north in a smooth cliff-face.

>look north
You can make out nothing that way.

* * *

>look north
You look north and find yourself confronted by the cliff you just jumped from. Does it seem taller than it did when you were on top?

>go north
Jumping down into the sand is one thing: climbing this is another. You reach for a handhold, but wind and sand have worn the cliff face smooth to the touch.

* * *

>look east
The sandy expanse stretches on past the horizon.

>look south
Look south, you see a giant tree bleached white by the sun.

* * *

>look north
You look north and find yourself confronted by the cliff you just jumped from. Does it seem taller than it did when you were on top?

>look south
You make out Tree in the Desert that way.

* * *

>s
Tree in the Desert
An ancient, gnarled tree stands alone in the sands bleached white by the heat of the sun. Hanging from the one of the highest branches is a ladder dangling just above you.

>look at ladder
You make out ladder that way.

* * *

>look south
Peering over the cliff, you see a sandy expanse perhaps 5 meters below you. Maybe it's a soft landing?

>test me
(Testing.)

>[1] look
Awning
A tan awning is stretched on tent poles over the dig-site, providing a little shade to the workers here; you are at the bottom of a square twenty feet on a side, marked out with pegs and lines of string. Uncovered in the south face of this square is an awkward opening into the earth.

>[2] s

Slightly Wrong Chamber
When you first step into the room, you are bothered by the sense that something is not quite right: perhaps the lighting, perhaps the angle of the walls. A mural on the far wall depicts a woman with a staff, tipped with a pine-cone. She appears to be watching you.

>[3] look
Slightly Wrong Chamber
A mural on the far wall depicts a woman with a staff, tipped with a pine-cone. She appears to be watching you.

* * *

A Treehouse Beneath The Cliff
An Interactive Fiction by FIGBERT
Release 1 / Serial number 200701 / Inform 7 build 6M62 (I6/v6.34 lib 6/12N) SD

Plateau
You awake to find youself prone on the ground. You look around to see a grassy field that seems to stretch on forever in all directions, ending abruptly half a meter south of you. You scramble quickly away from the edge. You look around and see an endless landscape of grass, flat for kilometers in all directions except south, where it ends in an sudden dropoff.

>look west
The green grass field stretches on past the horizon.

>go south
Desert
You leap out from the grassy plateau and fall downwards through the air, hitting the sand with a resounding thump. You find yourself in a sandy expanse stretching out southward, ending abruptly to the north in a smooth cliff-face.

>look west
Looking west

* * *

>look east
The green grass field stretches on past the horizon.

>look south
The green grass field stretches on past the horizon.

* * *

A Treehouse Beneath The Cliff
An Interactive Fiction by FIGBERT
Release 1 / Serial number 200701 / Inform 7 build 6M62 (I6/v6.34 lib 6/12N) SD

Plateau
You awake to find youself prone on the ground. You look around to see a grassy field that seems to stretch on forever in all directions, ending abruptly half a meter south of you. You scramble quickly away from the edge. You look around and see an endless landscape of grass, flat for kilometers in all directions except south, where it ends in an sudden dropoff.

>north
Hallway
A short hallway with three doors that opens out into a wider room.

>look
Hallway
A short hallway with three doors that opens out into a wider room.

* * *

>north
Hallway
A short hallway with three doors that opens out into a wider room.

>north
Parents' Bedroom
You can see Big Bed and Large Dresser here.

>south
Hallway
A short hallway with three doors that opens out into a wider room.

>northeast
Bathroom
You can see a toilet, a sink and a bath here.

>southwest
Hallway
A short hallway with three doors that opens out into a wider room.

>east
Living Room
You can see a couch here.

>west
Hallway
A short hallway with three doors that opens out into a wider room.

* * *

A Treehouse Beneath The Cliff
An Interactive Fiction by FIGBERT
Release 1 / Serial number 200701 / Inform 7 build 6M62 (I6/v6.34 lib 6/12N) SD

Plateau
You awake to find youself prone on the ground. You look around to see a grassy field that seems to stretch on forever in all directions, ending abruptly half a meter south of you. You scramble quickly away from the edge. You look around and see an endless landscape of grass, flat for kilometers in all directions except south, where it ends in an sudden dropoff.

>rub brass lamp
You rub the brass lamp, and your vision flashes a bright white.
...
...

TEN THOUSAND YEARS I HAVE RESTED
WHO DISTURBS MY SLUMBER

    *** The End ***

Would you like to RESTART, RESTORE a saved game, QUIT or UNDO the last command?

* * *

A Treehouse Beneath The Cliff
An Interactive Fiction by FIGBERT
Release 1 / Serial number 200701 / Inform 7 build 6M62 (I6/v6.34 lib 6/12N) SD

Plateau
You awake to find youself prone on the ground. You look around to see a grassy field that seems to stretch on forever in all directions, ending abruptly half a meter south of you. You scramble quickly away from the edge. You look around and see an endless landscape of grass, flat for kilometers in all directions except south, where it ends in an sudden dropoff.

>rub lamp
You must supply a noun.

>rub the lamp
You can't see any such thing.

>south
Desert
You leap out from the grassy plateau and fall downwards through the air, hitting the sand with a resounding thump. You find yourself in a sandy expanse stretching out southward, ending abruptly to the north in a smooth cliff-face.

>south
Tree in the Desert
An ancient, gnarled tree stands alone in the sands bleached white by the heat of the sun. Hanging from the one of the highest branches is a ladder dangling just above you.

>jump
You flex your legs and jump with all your might, and you manage to catch the final rung of the latter. You pull yourself up the rungs one-by-one, and collapse on the platform.

Treehouse
You straighten yourself up, and look around the platform.The treehouse is less of a house and more of a platform, built of warped branches washed as white as the rest of the tree. On the far side of the platform is a leather pouch.

>open pouch
You open the leather pouch, revealing a brass lamp.

>take lamp
Taken.

>rub lamp
You must supply a noun.

>rub the lamp
You rub the brass lamp.

* * *

A Treehouse Beneath The Cliff
An Interactive Fiction by FIGBERT
Release 1 / Serial number 200701 / Inform 7 build 6M62 (I6/v6.34 lib 6/12N) SD

Plateau
You awake to find youself prone on the ground. You look around to see a grassy field that seems to stretch on forever in all directions, ending abruptly half a meter south of you. You scramble quickly away from the edge. You look around and see an endless landscape of grass, flat for kilometers in all directions except south, where it ends in an sudden dropoff.

>s
Desert
You leap out from the grassy plateau and fall downwards through the air, hitting the sand with a resounding thump. You find yourself in a sandy expanse stretching out southward, ending abruptly to the north in a smooth cliff-face.

* * *

>s
Tree in the Desert
An ancient, gnarled tree stands alone in the sands bleached white by the heat of the sun. Hanging from the one of the highest branches is a ladder dangling just above you.

>j
That's not a verb I recognise.

>jump
You flex your legs and jump with all your might, and you manage to catch the final rung of the latter. You pull yourself up the rungs one-by-one, and collapse on the platform.

Treehouse
You straighten yourself up, and look around the platform.The treehouse is less of a house and more of a platform, built of warped branches washed as white as the rest of the tree. On the far side of the platform is a leather pouch.

* * *

>open pouch
You open the leather pouch, revealing a brass lamp.

>rub lamp
You rub the brass lamp.

>rub the brass lamp
You rub the brass lamp.

* * *

>s
Tree in the Desert
An ancient, gnarled tree stands alone in the sands bleached white by the heat of the sun. Hanging from the one of the highest branches is a ladder dangling just above you.

>jumip
That's not a verb I recognise.

>jump
You start your jump up towards the ladder, but the pressure you put on your foot before jumping causes the sand to shif as you begin your jump and you miss the ladder.

* * *

>jump
You flex your legs and jump with all your might, and you manage to catch the final rung of the latter. You pull yourself up the rungs one-by-one, and collapse on the platform.

Treehouse
You straighten yourself up, and look around the platform.The treehouse is less of a house and more of a platform, built of warped branches washed as white as the rest of the tree. On the far side of the platform is a leather pouch.

>open pouch
It isn't something you can open.

>open leather pouch
It isn't something you can open.

>look in pouch
In leather pouch is a brass lamp.

>take lamp
Taken.

>look at lamp
A sturdy brass lamp that glints in the sunlight. When you touch the lamp, you feel... different.

* * *

>s
Tree in the Desert
An ancient, gnarled tree stands alone in the sands bleached white by the heat of the sun. Hanging from the one of the highest branches is a ladder dangling just above you.

>jump
You start your jump up towards the ladder, but the pressure you put on your foot before jumping causes the sand to shif as you begin your jump and you miss the ladder.

>go down
Tree in the Desert
An ancient, gnarled tree stands alone in the sands bleached white by the heat of the sun. Hanging from the one of the highest branches is a ladder dangling just above you.

* * *

>jump
You flex your legs and jump with all your might, and you manage to catch the final rung of the latter. You pull yourself up the rungs one-by-one, and collapse on the platform.

Treehouse
A house in a tree.

>do down
That's not a verb I recognise.

>jump
You jump on the spot.

>d
Tree in the Desert
An ancient, gnarled tree stands alone in the sands bleached white by the heat of the sun. Hanging from the one of the highest branches is a ladder dangling just above you.

>jump
You start your jump up towards the ladder, but the pressure you put on your foot before jumping causes the sand to shif as you begin your jump and you miss the ladder.

>d
You can't go that way.

>jump
You flex your legs and jump with all your might, and you manage to catch the final rung of the latter. You pull yourself up the rungs one-by-one, and collapse on the platform.

Treehouse
A house in a tree.

>d
Tree in the Desert
An ancient, gnarled tree stands alone in the sands bleached white by the heat of the sun. Hanging from the one of the highest branches is a ladder dangling just above you.

* * *

>jump
You start your jump up towards the ladder, but the pressure you put on your foot before jumping causes the sand to shif as you begin your jump and you miss the ladder.

>jum
That's not a verb I recognise.

>jump
You flex your legs and jump with all your might, and you manage to catch the final rung of the latter. You pull yourself up the rungs one-by-one, and collapse on the platform.

Treehouse
You straighten yourself up, and look around the platform.The treehouse is less of a house and more of a platform, built of warped branches washed as white as the rest of the tree. On the far side of the platform is a leather pouch.

>look at pouch
A small pouch of leather, oiled on the outside to resist the weather. The pouch is tied closed with a string.

>open pouch
You open the leather pouch, revealing a brass lamp.

>look at pouch
A small pouch of leather, oiled on the outside to resist the weather.

In the leather pouch is a brass lamp.

>take lamp
Taken.

* * *

>look at lamp
A sturdy brass lamp that glints in the sunlight. When you touch the lamp, you feel... different.

>examine lamp
A sturdy brass lamp that glints in the sunlight. When you touch the lamp, you feel... different.

>look south
You can't see anything promising that way.

>use lamp
That's not a verb I recognise.

>interact with lamp
That's not a verb I recognise.

* * *

>go down
Tree in the Desert
An ancient, gnarled tree stands alone in the sands bleached white by the heat of the sun. Hanging from the one of the highest branches is a ladder dangling just above you.

>jump
You start your jump up towards the ladder, but the pressure you put on your foot before jumping causes the sand to shif as you begin your jump and you miss the ladder.

>jumo
That's not a verb I recognise.

>jump
You start your jump up towards the ladder, but the pressure you put on your foot before jumping causes the sand to shif as you begin your jump and you miss the ladder.

>jump
You flex your legs and jump with all your might, and you manage to catch the final rung of the latter. You pull yourself up the rungs one-by-one, and collapse on the platform.

Treehouse
A house in a tree.

* * *

>jum
That's not a verb I recognise.

>jump
You start your jump up towards the ladder, but the pressure you put on your foot before jumping causes the sand to shif as you begin your jump and you miss the ladder.

* * *

>jump
You flex your legs and jump with all your might, and you manage to catch the final rung of the latter. You pull yourself up the rungs one-by-one, and collapse on the platform.

Treehouse
You straighten yourself up, and look around the platform.The treehouse is less of a house and more of a platform, built of warped branches washed as white as the rest of the tree. On the far side of the platform is a leather pouch.

>look at leather pouh
That noun did not make sense in this context.

>look at leather pouch
A small pouch of leather, oiled on the outside to resist the weather

>open pouch
It isn't something you can open.

* * *

>jump
You flex your legs and jump with all your might, and you manage to catch the final rung of the latter. You pull yourself up the rungs one-by-one, and collapse on the platform.

Treehouse
You straighten yourself up, and look around the platform.The treehouse is less of a house and more of a platform, built of warped branches washed as white as the rest of the tree. On the far side of the platform is a leather pouch.

>go down
The platform doesn't seem too stable... It's probably best to stay still.

>go north
The platform doesn't seem too stable... It's probably best to stay still.

>go up
The platform doesn't seem too stable... It's probably best to stay still.

* * *

>jump
You flex your legs and jump with all your might, and you manage to catch the final rung of the latter. You pull yourself up the rungs one-by-one, and collapse on the platform.

Treehouse
You straighten yourself up, and look around the platform.The treehouse is less of a house and more of a platform, built of warped branches washed as white as the rest of the tree. On the far side of the platform is a leather pouch.

>jump
You start your jump up towards the ladder, but the pressure you put on your foot before jumping causes the sand to shif as you begin your jump and you miss the ladder.

* * *

>take lamp
Taken.

>rub lamp
You rub the brass lamp.

* * *

>jump
You start your jump up towards the ladder, but the pressure you put on your foot before jumping causes the sand to shif as you begin your jump and you miss the ladder.

>look at pouch
A small pouch of leather, oiled on the outside to resist the weather. The pouch is tied closed with a string.

>open pouch
You open leather pouch, revealing a brass lamp.

>look at pouch
A small pouch of leather, oiled on the outside to resist the weather.

In leather pouch is a brass lamp.

* * *

>open pouch
You open the leather pouch, revealing a brass lamp.

>rub lamp
fuck

* * *

>jump
You start your jump up towards the ladder, but the pressure you put on your foot before jumping causes the sand to shif as you begin your jump and you miss the ladder.

>open pouch
You open the leather pouch, revealing a brass lamp.

>rub brass lamp
You rub the brass lamp, and your vision flashes a bright white.
...
...

TEN THOUSAND YEARS I HAVE RESTED
WHO DISTURBS MY SLUMBER

    *** The End ***

Would you like to RESTART, RESTORE a saved game, QUIT or UNDO the last command?

* * *

>open pouch
You open the leather pouch, revealing a brass lamp.

>rub brass lamp
You rub the brass lamp, and your vision flashes a bright white.
...
...

TEN THOUSAND YEARS WILL GIVE YOU SUCH A CRICK IN THE NECK

    *** The End ***

Would you like to RESTART, RESTORE a saved game, QUIT or UNDO the last command?

>undo
Treehouse
[Previous turn undone.]

>go down
Tree in the Desert
An ancient, gnarled tree stands alone in the sands bleached white by the heat of the sun. Hanging from the one of the highest branches is a ladder dangling just above you.

>rub brass lamp
You can't reach into the Treehouse.

* * *

>take lamp
Taken.

>rub lamp
You rub the brass lamp, and your vision flashes a bright white.
...
...

TEN THOUSAND YEARS I HAVE RESTED
WHO DISTURBS MY SLUMBER

    *** The End ***

Would you like to RESTART, RESTORE a saved game, QUIT or UNDO the last command?

>undo
Treehouse
[Previous turn undone.]

* * *

>open pouch
You open the leather pouch, revealing a brass lamp.

>take the lamp
Taken.

>rub the lamp
You rub the brass lamp.

>rub the thing
You can't see any such thing.

* * *

>jump
You start your jump up towards the ladder, but the pressure you put on your foot before jumping causes the sand to shif as you begin your jump and you miss the ladder.

>look at pouch
That noun did not make sense in this context.

>open pouch
You can't see any such thing.

* * *

>take lamp
Taken.

>look at pouch
A small pouch of leather, oiled on the outside to resist the weather.

>put lamp in pouch
You put the brass lamp into leather pouch.

>look at pouch
A small pouch of leather, oiled on the outside to resist the weather.

In leather pouch is a brass lamp.

* * *

>open pouch
You open the leather pouch, revealing a brass lamp.

>rub brass lam
I only understood you as far as wanting to rub the brass lamp.

>rub brass lamp
What?

>take lamp
Taken.

>rub the lamp
You rub the brass lamp, and your vision flashes a bright white.
...
...

TEN THOUSAND YEARS WILL GIVE YOU SUCH A CRICK IN THE NECK

    *** The End ***

Would you like to RESTART, RESTORE a saved game, QUIT or UNDO the last command?

* * *

>look at ladder
A rope ladder connected by sturdy white branches, apparently from the tree itself. It hangs from high up in the tree, and ends 2 meters above the ground.

>examine ladder
A rope ladder connected by sturdy white branches, apparently from the tree itself. It hangs from high up in the tree, and ends 2 meters above the ground.

* * *

A Treehouse Beneath The Cliff
An Interactive Fiction by FIGBERT
Release 1 / Serial number 200701 / Inform 7 build 6M62 (I6/v6.34 lib 6/12N) SD

Plateau
You awake to find youself prone on the ground. You look around to see a grassy field that seems to stretch on forever in all directions, ending abruptly half a meter south of you. You scramble quickly away from the edge. You look around and see an endless landscape of grass, flat for kilometers in all directions except south, where it ends in an sudden dropoff.

>south
Desert
You leap out from the grassy plateau and fall downwards through the air, hitting the sand with a resounding thump. You find yourself in a sandy expanse stretching out southward, ending abruptly to the north in a smooth cliff-face.

>s
Tree in the Desert
An ancient, gnarled tree stands alone in the sands bleached white by the heat of the sun. Hanging from the one of the highest branches is a ladder dangling just above you.

>jump
You start your jump up towards the ladder, but the pressure you put on your foot before jumping causes the sand to shift as you begin your jump and you miss the ladder.

>jump
You jump... and fall on your butt. At least nobody saw, given that you're alone in a baren desert and all.

>jump
You jump and grab the rung, but the tug of your weight one shoulder sends you falling back down to the sand and nearly wrenches your arm from its socket.

>jump
You jump... and fall on your butt. At least nobody saw, given that you're alone in a baren desert and all.

>juimp
That's not a verb I recognise.

>jump
You flex your legs and jump with all your might, and you manage to catch the final rung of the latter. You pull yourself up the rungs one-by-one, and collapse on the platform.

Treehouse
You straighten yourself up, and look around the platform.The treehouse is less of a house and more of a platform, built of warped branches washed as white as the rest of the tree. On the far side of the platform is a leather pouch.

* * *

>jump
You start your jump up towards the ladder, but the pressure you put on your foot before jumping causes the sand to shift as you begin your jump and you miss the ladder.

>look at pouch
A small pouch of leather, oiled on the outside to resist the weather

* * *

>south
Tree in the Desert
An ancient, gnarled tree stands alone in the sands bleached white by the heat of the sun. Hanging from the one of the highest branches is a ladder dangling just above you.

>jump
You start your jump up towards the ladder, but the pressure you put on your foot before jumping causes the sand to shif as you begin your jump and you miss the ladder.

>juimp
That's not a verb I recognise.

>jump
You start your jump up towards the ladder, but the pressure you put on your foot before jumping causes the sand to shif as you begin your jump and you miss the ladder.

* * *

>open pouch
You can't see any such thing.

>take lamp
You can't see any such thing.

>rub lamp
You can't see any such thing.

>jump
You start your jump up towards the ladder, but the pressure you put on your foot before jumping causes the sand to shif as you begin your jump and you miss the ladder.

* * *

>jump
You flex your legs and jump with all your might, and you manage to catch the final rung of the latter. You pull yourself up the rungs one-by-one, and collapse on the platform.

Treehouse
You straighten yourself up, and look around the platform.The treehouse is less of a house and more of a platform, built of warped branches washed as white as the rest of the tree. On the far side of the platform is a leather pouch.

>open pouc
You can't see any such thing.

>open pouch
You open the leather pouch, revealing a brass lamp.

* * *

>rub lamp
You rub the brass lamp.

>drop lamp
Dropped.

>rub lamp
You rub the brass lamp.

>rub lamp
You rub the brass lamp.

* * *

>take lamp
Taken.

>rub the lamp
You rub the brass lamp.

>rub lamp
You rub the brass lamp.

* * *

A Treehouse Beneath The Cliff
An Interactive Fiction by FIGBERT
Release 1 / Serial number 200701 / Inform 7 build 6M62 (I6/v6.34 lib 6/12N) SD

Plateau
You awake to find youself prone on the ground. You look around to see a grassy field that seems to stretch on forever in all directions, ending abruptly half a meter south of you. You scramble quickly away from the edge. You look around and see an endless landscape of grass, flat for kilometers in all directions except south, where it ends in an sudden dropoff.

>test
>--> The following tests are available:
'test me'

>test me
(Testing.)

>[1] look
Plain of the Skull
A vast and trackless plain, enlivened only by the bones of those who have previously tried and failed to cross. Above you is the Endless Tower, which rises half-way to the moon.

>[2] up
You climb... and climb... and climb... The sun sets. The moon rises. The wind begins to blow. You continue to climb...

Endless Tower
From up here the Plain of the Skull seems only a small bald patch: the world is round and most of it is covered with trees. Far off to the southwest is a shimmering surface that might be water; but there are no signs of cities or civilizations, only the lizard-skeletons.

* * *

A Treehouse Beneath The Cliff
An Interactive Fiction by FIGBERT
Release 1 / Serial number 200701 / Inform 7 build 6M62 (I6/v6.34 lib 6/12N) SD

Plateau
You awake to find youself prone on the ground. You look around to see a grassy field that seems to stretch on forever in all directions, ending abruptly half a meter south of you. You scramble quickly away from the edge. You look around and see an endless landscape of grass, flat for kilometers in all directions except south, where it ends in an sudden dropoff.

>test me
(Testing.)

>[1] look through window
Through the window, you make out the Grassy Slope.

>[2] climb through window
The window is shut: you'd break the glass.

>[3] open window
You open the bedroom window.

>[4] climb through window

Grassy Slope
You can see a bedroom window here.

>[5] look through window
Through the window, you make out Your Bedroom.

>[6] close window
You close the bedroom window.

>[7] e
The window is shut: you'd break the glass.

>[8] open window
You open the bedroom window.

>[9] e

Your Bedroom
You can see a bedroom window here.