Challenge Three
An Interactive Fiction by FIGBERT
Release 1 / Serial number 200703 / Inform 7 build 6M62 (I6/v6.34 lib 6/12N) SD

Example Location
A white cube, expaning on to the north, south, east, and west.

You can see Jonny here.

>e
Example Location - East
More blank cube.

A pristine blue button is attached to the floor here.

You can hear Jonny humming a morose tune the room over.

>push button
Nothing obvious happens.

You can hear Jonny humming a morose tune the room over.

>examine button
A dark blue button with the text "END SIMULATION" printed on it in thick, white letters.

You can hear Jonny humming a morose tune the room over.

* * *

Challenge Three
An Interactive Fiction by FIGBERT
Release 1 / Serial number 200703 / Inform 7 build 6M62 (I6/v6.34 lib 6/12N) SD

Example Location
A white cube, expaning on to the north, south, east, and west.

You can see Jonny here.

>east
Kukuriku
You can hear Jonny humming a morose tune.

>east
Hat
You can hear Jonny humming a morose tune.

>west
Kukuriku
You can hear Jonny humming a morose tune.

>west
Example Location
You can see Jonny here.

Jonny's has a confusing look on his face, almost as if he's trying not to cry.

>hold jonny's hand
You can't see any such thing.

>hold hands with jonny
You take their hand in yours.

Jonny has a nice smile on his face, and he's bopping his head up and down to music that you can't hear.

>go east
Kukuriku
Jonny arrives from the west.

Jonny has a nice smile on his face, and he's bopping his head up and down to music that you can't hear.

>go east
Hat
Jonny arrives from the west.

Jonny has a nice smile on his face, and he's bopping his head up and down to music that you can't hear.

>go west
Kukuriku
Jonny arrives from the east.

Jonny has a nice smile on his face, and he's bopping his head up and down to music that you can't hear.

>go east
Hat
Jonny arrives from the west.

Jonny has a nice smile on his face, and he's bopping his head up and down to music that you can't hear.

* * *

>go west
Kukuriku
Jonny arrives from the east.

Jonny has a nice smile on his face, and he's bopping his head up and down to music that you can't hear.

>go west
Example Location
Jonny arrives from the east.

Jonny has a nice smile on his face, and he's bopping his head up and down to music that you can't hear.

* * *

Challenge Three
An Interactive Fiction by FIGBERT
Release 1 / Serial number 200703 / Inform 7 build 6M62 (I6/v6.34 lib 6/12N) SD

Example Location
A white cube, expaning on to the north, south, east, and west.

You can see Jonny here.

>go east
Example Location - East
More blank cube.

You can hear Jonny humming a morose tune.

* * *

Challenge Three
An Interactive Fiction by FIGBERT
Release 1 / Serial number 200703 / Inform 7 build 6M62 (I6/v6.34 lib 6/12N) SD

Example Location
A white cube, expaning on to the north, south, east, and west.

You can see Jonny here.

>hold hands with Jonny
You take their hand in yours.

>go w
You can't go that way.

>go e
Kukuriku
Jonny arrives from the west.

>go e
Hat
Jonny arrives from the west.

>go w
Kukuriku
Jonny arrives from the east.

>go w
Example Location
Jonny arrives from the east.

* * *

>hold hands with Jonny
You take their hand in yours.

>let go of Jonny
You loosen your grip, and slide your hand out from theirs.

Jonny is free.

>look
Example Location
You can see Jonny here.

Jonny is free.

>exit
But you aren't in anything at the moment.

Jonny is free.

>stop
(holding hands with Jonny)
You loosen your grip, and slide your hand out from theirs.

Jonny is free.

* * *

Challenge Three
An Interactive Fiction by FIGBERT
Release 1 / Serial number 200703 / Inform 7 build 6M62 (I6/v6.34 lib 6/12N) SD

Example Location
A white cube, expaning on to the north, south, east, and west.

You can see Jonny here.

>let go of Jonny
You're not holding their hand!

Jonny is free.

* * *

Challenge Three
An Interactive Fiction by FIGBERT
Release 1 / Serial number 200703 / Inform 7 build 6M62 (I6/v6.34 lib 6/12N) SD

Example Location
A white cube, expaning on to the north, south, east, and west.

You can see Jonny here.

>take Jonny
I don't suppose Jonny would care for that.

Jonny's has a confusing look on his face, almost as if he's trying not to cry.

>hold hands with Jonny
You take their hand in yours.

Jonny has a nice smile on his face, and he's bopping his head up and down to music that you can't hear.

>go east
Example Location - East
More blank cube.

A pristine blue button is attached to the floor here.

Jonny arrives from the west.

Jonny has a nice smile on his face, and he's bopping his head up and down to music that you can't hear.

>x button
A dark blue button with the text "END SIMULATION" printed on it in thick, white letters.

Jonny has a nice smile on his face, and he's bopping his head up and down to music that you can't hear.

>press button
Beginning shutdown process...
Defragging...
Clearing out temporary directories...
Cleaning user cache...
Spinning down...

    *** The End ***

Would you like to RESTART, RESTORE a saved game, QUIT or UNDO the last command?

>undo
Example Location - East
[Previous turn undone.]