Escape
An Interactive Fiction by FIGBERT
Release 1 / Serial number 200706 / Inform 7 build 6M62 (I6/v6.34 lib 6/12N) SD

Example Location
Your eyes blink open. Your head throbs from where I hit you with my bat. I knocked you out for daring to play my game. You appear to be in an empty white cube.

Lying in the center of the room are a pair of horrible goggles.

>go west
You can't go that way.

>go east
You can't go that way.

>go up
You can't go that way.

>wear goggles
(first taking goggles)
You put on the goggles, and two identical deep-blue doors materialize on opposite sides of the cube, to the east and west. Taped to each door using that annoying double-sided tape are two identical Hello Kitty keys made from cheap plastic.

Because the only thing I am certain of is your inadequacy, I will clarify that these objects are referred to as East/West Key and East/West Door. Pick the right door and go through it to escape.

>take west key
Taken.

>open west door
It seems to be locked.

>unlock west door with west key
You unlock West Door.

>go west
tembel

    *** You Lose ***

Would you like to RESTART, RESTORE a saved game, QUIT or UNDO the last command?

>go through the West Door
Please give one of the answers above.

Would you like to RESTART, RESTORE a saved game, QUIT or UNDO the last command?

>undo
Example Location
[Previous turn undone.]

>go through the west door
(first opening West Door)
You can't, since West Door leads nowhere.

* * *

Escape
An Interactive Fiction by FIGBERT
Release 1 / Serial number 200706 / Inform 7 build 6M62 (I6/v6.34 lib 6/12N) SD

Example Location
Your eyes blink open. Your head throbs from where I hit you with my bat. I knocked you out for daring to play my game. You appear to be in an empty white cube.

Lying in the center of the room are a pair of horrible goggles.

>look
Example Location
An empty white cube. Resting on the ground in front of you is a worn burlap potato sack. You think about resting in it, because it looks just about as comfortable as a person like you deserves. Probably best not to do that, because you might offend me even more by using an important game piece as a bed.

>take goggles
You can't see any such thing.

>take the pair of goggles
You can't see any such thing.

* * *

>look
Example Location
An empty white cube. Resting on the ground in front of you is a worn burlap potato sack. You think about resting in it, because it looks just about as comfortable as a person like you deserves. Probably best not to do that, because you might offend me even more by using an important game piece as a bed.

>take sack
You can't see any such thing.

>look at asck
You can't see any such thing.

>examine sack
A worn burlap sack tied closed with a strip of similar material. It looks like before it was used by me as an awesome game piece, it was probably used to carry potatoes and other lame stuff.

>open sack
You open the potato sack, revealing goggles.

>x goggles
The ugliest swim goggles you have ever seen - like the used, worn-out kind you get from pool life guards but worse. They've probably been chewed up by little kids, rats, and me.

* * *

>take sack
You can't see any such thing.

>take potato sack
You can't see any such thing.

>open sack
You can't see any such thing.

* * *

Escape
An Interactive Fiction by FIGBERT
Release 1 / Serial number 200706 / Inform 7 build 6M62 (I6/v6.34 lib 6/12N) SD

Example Location
Your eyes blink open. Your head throbs from where I hit you with my bat. I knocked you out for daring to play my game. You appear to be in an empty white cube.

Lying in the center of the room are a pair of horrible goggles.

>look at west key
A key.

>take west key
That's hardly portable.

>wear goggles
(first taking goggles)
You put on the goggles, and two identical deep-blue doors materialize on opposite sides of the cube, to the east and west. Taped to each door using that annoying double-sided tape are two identical Hello Kitty keys made from cheap plastic.

Because the only thing I am certain of is your inadequacy, I will clarify that these objects are referred to as East/West Key and East/West Door.

>take west key
Taken.

* * *

Escape
An Interactive Fiction by FIGBERT
Release 1 / Serial number 200706 / Inform 7 build 6M62 (I6/v6.34 lib 6/12N) SD

Example Location
Your eyes blink open. Your head throbs from where I hit you with my bat. I knocked you out for daring to play my game. You appear to be in an empty white cube.

Lying in the center of the room are a pair of horrible goggles.

>open sack
You open the potato sack, revealing goggles.

>wear goggles
(first taking goggles)
penis

* * *

Escape
An Interactive Fiction by FIGBERT
Release 1 / Serial number 200706 / Inform 7 build 6M62 (I6/v6.34 lib 6/12N) SD

Example Location
Your eyes blink open. Your head throbs from where I hit you with my bat. I knocked you out for daring to play my game. You appear to be in an empty white cube.

Lying in the center of the room are a pair of horrible goggles.

>take gogglees
You can't see any such thing.

>take goggles
Taken.

>wear goggles
You put on the goggles, and two identical deep-blue doors materialize on opposite sides of the cube, to the east and west. Taped to each door using that annoying double-sided tape are two identical Hello Kitty keys made from cheap plastic.

Because the only thing I am certain of is your inadequacy, I will clarify that these objects are referred to as East/West Key and East/West Door. Pick the right door and go through it to escape.

>examine goggles
The ugliest swim goggles you have ever seen - like the used, worn-out kind you get from pool life guards but worse. They've probably been chewed up by little kids, rats, and me.

>unlock east door
(with goggles)
That doesn't seem to fit the lock.

>take east key
Taken.

>unlock east door
What do you want to unlock East Door with?

>unlock east door with east ke
You can't see any such thing.

>unlock east door with east key
You unlock East Door.

>go east
You win. Not bad for a sapien such as yourself.

    *** You Win, as much as you can in this game ***

Would you like to RESTART, RESTORE a saved game, QUIT or UNDO the last command?

* * *

Escape
An Interactive Fiction by FIGBERT
Release 1 / Serial number 200706 / Inform 7 build 6M62 (I6/v6.34 lib 6/12N) SD

Example Location
Your eyes blink open. Your head throbs from where I hit you with my bat. I knocked you out for daring to play my game. You appear to be in an empty white cube.

Lying in the center of the room are a pair of horrible goggles.

>take goggles
Taken.

>look
Example Location
An empty white cube. Resting on the ground in front of you are a pair of the ugliest swim goggles you have ever seen - like the used, worn-out kind you get from pool life guards but worse. They've probably been chewed up by little kids, rats, and me.

* * *

>take goggles
Taken.

>wear goggles
You put on the goggles, and two identical deep-blue doors materialize on opposite sides of the cube, to the east and west. Taped to each door using that annoying double-sided tape are two identical Hello Kitty keys made from cheap plastic.

Because the only thing I am certain of is your inadequacy, I will clarify that these objects are referred to as East/West Key and East/West Door.

>open west door
You open West Door.

>open east door
You open East Door.

>x east door
A door.

>x west door
A door.

* * *

>wear goggles
You put on the goggles, and two identical deep-blue doors materialize on opposite sides of the cube, to the east and west. Taped to each door using that annoying double-sided tape are two identical Hello Kitty keys made from cheap plastic.

Because the only thing I am certain of is your inadequacy, I will clarify that these objects are referred to as East/West Key and East/West Door.

>take east key
Taken.

>open east door
It seems to be locked.

>unlock east door
What do you want to unlock East Door with?

>unlock east door with east key
You unlock East Door.

>go through east door
(first opening East Door)
You can't, since East Door leads nowhere.

* * *

>wear goggles
You put on the goggles, and two identical deep-blue doors materialize on opposite sides of the cube, to the east and west. Taped to each door using that annoying double-sided tape are two identical Hello Kitty keys made from cheap plastic.

Because the only thing I am certain of is your inadequacy, I will clarify that these objects are referred to as East/West Key and East/West Door.

>x west key
A key.

>x east key
A key.

* * *

Escape
An Interactive Fiction by FIGBERT
Release 1 / Serial number 200706 / Inform 7 build 6M62 (I6/v6.34 lib 6/12N) SD

Example Location
Your eyes blink open. Your head throbs from where I hit you with my bat. I knocked you out for daring to play my game. You appear to be in an empty white cube.

Lying in the center of the room are a pair of horrible goggles.

>take sack
Taken.

>look
Example Location
An empty white cube. Something.

* * *

>take sack
Taken.

>open sack
You open the potato sack, revealing goggles.

>wear goggles
(first taking goggles)
You're carrying too many things already.

* * *

Escape
An Interactive Fiction by FIGBERT
Release 1 / Serial number 200706 / Inform 7 build 6M62 (I6/v6.34 lib 6/12N) SD

Example Location
Your eyes blink open. Your head throbs from where I hit you with my bat. I knocked you out for daring to play my game. You appear to be in an empty white cube.

Lying in the center of the room are a pair of horrible goggles.

>wear goggles
(first taking goggles)
You put on the goggles, and two identical deep-blue doors materialize on opposite sides of the cube, to the east and west. Taped to each door using that annoying double-sided tape are two identical Hello Kitty keys made from cheap plastic.

Because the only thing I am certain of is your inadequacy, I will clarify that these objects are referred to as East/West Key and East/West Door. Pick the right door and go through it to escape.

>look at guide
A pristine human specimin, totally jacked and freshly groomed. Looks as if he has just emerged from the shower, as he has a faintly wet... aura? Maybe it's just in your mind,.

>take apple
You can't see any such thing.

* * *

>wear goggles
(first taking goggles)
You put on the goggles, and two identical deep-blue doors materialize on opposite sides of the cube, to the east and west. Taped to each door using that annoying double-sided tape are two identical Hello Kitty keys made from cheap plastic.

Because the only thing I am certain of is your inadequacy, I will clarify that these objects are referred to as East/West Key and East/West Door. Pick the right door and go through it to escape.

>take east key
Taken.

>take west key
Taken.

>i
You are carrying:
  West Key
  East Key
  goggles (being worn)

>open west door with west key
You unlock West Door.

>go west
(first opening West Door)
You can't, since West Door leads nowhere.

* * *

>take west key
Taken.

>take east key
Taken.

>unlock east door with east key
You unlock East Door.

* * *

>go through east door
(first opening East Door)
You can't, since East Door leads nowhere.

>go through east door
You can't, since East Door leads nowhere.

* * *

Escape
An Interactive Fiction by FIGBERT
Release 1 / Serial number 200706 / Inform 7 build 6M62 (I6/v6.34 lib 6/12N) SD

Example Location
Your eyes blink open. Your head throbs from where I hit you with my bat. I knocked you out for daring to play my game. You appear to be in an empty white cube.

Lying in the center of the room are a pair of horrible goggles.

>x east key
Penis

* * *

Escape
An Interactive Fiction by FIGBERT
Release 1 / Serial number 200706 / Inform 7 build 6M62 (I6/v6.34 lib 6/12N) SD

Example Location
Your eyes blink open. Your head throbs from where I hit you with my bat. I knocked you out for daring to play my game. You appear to be in an empty white cube.

Lying in the center of the room are a pair of horrible goggles.

>x goggles
The ugliest swim goggles you have ever seen - like the used, worn-out kind you get from pool life guards but worse. They've probably been chewed up by little kids, rats, and me.

>take goggles
Taken.

* * *

Escape
An Interactive Fiction by FIGBERT
Release 1 / Serial number 200706 / Inform 7 build 6M62 (I6/v6.34 lib 6/12N) SD

Example Location
Your eyes blink open. Your head throbs from where I hit you with my bat. I knocked you out for daring to play my game. You appear to be in an empty white cube.

Lying in the center of the room are a pair of horrible goggles.

>x sack
A worn burlap sack tied closed with a strip of similar material. It looks like before it was used by me as an awesome game piece, it was probably used to carry potatoes and other lame stuff.

>take sack
Taken.

* * *

>open sack
You open the potato sack, revealing goggles.

>take goggles
Taken.

>wear goggles
You put on goggles.

* * *

>take west key
Taken.