One Angry Wizard, or the Tentacular Adventures of our Brave Hero through a World Most Strange and Foreign
A puzzle game about an angry wizard by FIGBERT
Release 1 / Serial number 200722 / Inform 7 build 6M62 (I6/v6.34 lib 6/12N) SD

Great Room
Your eyes blink open, and you find yourself in the most grand room you've ever seen. The entire room is crafted from giant blocks of a sand-colored stone, stacked up to a ceiling high above where a massive mural is painted onto the rock.

I've trapped you in a pocket dimension (literally in my pocket, enjoy the crumbs) because I hate you. I hate you so much. You didn't buy me a present for my birthday, and now you'll pay the price.

To the south, a small blue door is embedded in the rock.

Behind you to the west you see a hallway, hewn out of the stone, leading to another room.

Before you to the east, taking up almost the entire wall, is a great metal door painted a deep blue and patterned with yellow and white veins that run throughout. At the base of the door are four keyholes and four doorknobs.

I beg your pardon?

>w
Cluttered Room
You pass through the stone hallway, and step out in to the most cluttered room you've ever seen. You spin around, and bump into a tall stack of chairs like a moron.

You find yourself in a room, half the size of the previous room, filled to the brim with chairs, folded tables, closed crates, and smaller tidbits scattered about.

Behind you to the east you see a hallway, hewn out of the stone, leading  to another room.

To the south, almost obscured behind a large gray couch, you see a door.

To your right you see a dented bucket overflowing with junk. Or maybe it's important items for progressing in the game.

The couch, lying to your left in front of the door, sags with (fake) age, and it's got tears in the tattered fabric in some places.

>look in couhc
You can't see any such thing.

>look in coucj
You can't see any such thing.

>look in couch
You search under the couch and under the cushions, and find a small key hiding underneath.

>take key
Taken.

>unlock door with key
You unlock the first door.

>s
(first opening the first door)

Cobble Wall
You push through the door, and find yourself in a tiny room that ends abruptly to your left in an ancient cobblestone wall. The wall stretches up high above, ending just before the ceiling. Rocks here and there seem to have fallen out of the wall over the ages it has stood in place, creating holes of varying sizes in the walls (though as I believe I've made clear, it's not actually ancient because it's fake so the holes have been there since I created it).

To the north you can see the door you came through earlier.

In the center of the wall to the east, you can see a hole as average as yourself. It's so normal it's dissapointing.

To the southeast, you can see a miniscule hole, barely larger than your average United State dime, a ten-cent coin, one tenth of a United States dollar, labeled formally as "one dime". The denomination was first authorized by the Coinage Act of 1792. The dime is the smallest in diameter and is the thinnest of all U.S. coins currently minted for circulation, being 0.705 inches (17.91 millimeters) in diameter and 0.053 in (1.35 mm) in thickness. The hole looks like that.

In the northeast of the wall, you see a hole roughly the size of a fist, punched through the rock in a feat of strength far out of reach of one such as yourself.

>se
Teensy Cave of Fortune
Behind you to the northwest, light streams in from the puny cave's entrance.

In the dust below your feet, a small silver key glints in the dim light.

>take key
(the second key)
Taken.

>nw
Cobble Wall
A tiny room that ends abruptly to your left in an ancient cobblestone wall. The wall stretches up high above, ending just before the ceiling. Rocks here and there seem to have fallen out of the wall over the ages it has stood in place, creating holes of varying sizes in the walls (though as I believe I've made clear, it's not actually ancient because it's fake so the holes have been there since I created it).

To the southeast, you can see a miniscule hole, barely larger than your average United State dime, a ten-cent coin, one tenth of a United States dollar, labeled formally as "one dime". The denomination was first authorized by the Coinage Act of 1792. The dime is the smallest in diameter and is the thinnest of all U.S. coins currently minted for circulation, being 0.705 inches (17.91 millimeters) in diameter and 0.053 in (1.35 mm) in thickness. The hole looks like that.

To the north you can see the door you came through earlier.

In the center of the wall to the east, you can see a hole as average as yourself. It's so normal it's dissapointing.

In the northeast of the wall, you see a hole roughly the size of a fist, punched through the rock in a feat of strength far out of reach of one such as yourself.

>insert second key with center hole
I didn't understand that sentence.

>insert second key to center hole
I didn't understand that sentence.

>insert second key into center hole
You insert the key you found into the hole in the wall, and hear a slight click. You turn the key to the left like a total dimwit, but correct yourself before the key snaps and twist the other direction. A small section of the wall eases forward with a sigh, revealing a passageway east.

>go through center hole
You push open the rocky door and move onwards through a short passageway.

Library
You arrive in a long room full of thousands and thousands of bookshelves, full to the brim with dust-covered tomes. An ancient library, with books on topics much to complex for you to understand. The shelves continue further south.

Behind you to the west, you see a rocky door in the wall.

To the east you see a thick metal door, its industrial design a strange contrast to the otherwise ancient design you've encountered in this world so far. Extruded from the door is a box labeled "KEY", apparently held closed by a 2-digit combination lock, which is a little odd for state-of-the-art security.

>s
Library (Shelf #1)
This section of the library is much the same as all the rest: shelves of books to either side, untouched books lying on their shelves. The main room is back to the north, and the shelves continue south.

Lying on the shelf to your left, a dustless green tome lies on its side. Gold lettering on its spine reads "The Dialogues of Plato." Lower down, its call number is printed: 184.2.

Standing on the right shelf, a tome with a suspicious amount of dust rests on the right shelf. Silver lettering on its spine reads "The Great Transformation," and below that its call number is written "200.9."

>s
Library (Shelf #2)
This section of the library is much the same as all the rest: shelves of books to either side, untouched books lying on their shelves. The library continues both north and south.

Directly in front of you, a white novel rests on the ground. Black type on its cover reads "Outliers." On its spine a call number is printed: 302.6.

Peeking over the edge of the right shelf, a yellow book hangs above your head face-down. From where you stand, you can see bold black-and-blue lettering, "Because Internet." On its spine, a call number reads "402.231."

>s
Library (Shelf #3)
This section of the library is much the same as all the rest: shelves of books to either side, untouched books lying on their shelves. A small glyph is carved into the wood of a shelf here that looks faintly like an "x," but you can't quite recognize what it is. The library continues both north and south.

On one of the shelves here, a dustless book rests facing you. On its cover, a detailed picture of a pie is partly obscured by the text, "Eight Pies," emblazoned in white. On its spine a call number is printed: 594.56.

Right next to the recipe book, a black book seems to have disturbed the dust. On its cover, yellow ASCII marks the book as "Cult of the Dead Cow." On its spine, a call number reads "605.8."

>s
Library (Shelf #4)
This section of the library is much the same as all the rest: shelves of books to either side, untouched books lying on their shelves. The row of shelves ends in a wall to the south, but you can head back northward.

In a small gap in the books, a blue book leans across: "Born a Crime." On its spine a call number is printed: 791.4502.

A white and red book lies flat on top of the other books here. Written in black about a great red pirate flag are the words, "Enemy of All Mankind." On its spine, a call number reads "910.45."

* * *

>W
Cluttered Room
You pass through the stone hallway, and step out in to the most cluttered room you've ever seen. You spin around, and bump into a tall stack of chairs like a moron.

You find yourself in a room, half the size of the previous room, filled to the brim with chairs, folded tables, closed crates, and smaller tidbits scattered about.

Behind you to the east you see a hallway, hewn out of the stone, leading  to another room.

To the south, almost obscured behind a large gray couch, you see a door.

To your right you see a dented bucket overflowing with junk. Or maybe it's important items for progressing in the game.

The couch, lying to your left in front of the door, sags with (fake) age, and it's got tears in the tattered fabric in some places.

>S
The Hedge Maze

>E
The Library

>E
The Mirror Maze

>N
The Aquarium

>N
The Crash Test

>W
The Computer Lab

>W
Floor of Keys

>SE
Empty Room
You can see Door with Eight Locks here.

>NW
Floor of Keys

>SE
Empty Room
You can see Door with Eight Locks here.

>W
Cluttered Room

* * *

>search couch
You search throughout the couch lazily and find only crumbs. You could scoop them up I guess?

>search couch
You search throughout the couch lazily and find only crumbs.
You could scoop them up I guess?

>search couch
You search throughout the couch lazily and find only crumbs.
You could scoop them up I guess?

>search couch
You search under the couch and under the cushions, and find a small key hiding underneath.

>search couch
You search throughout the couch lazily and find only crumbs.
You could scoop them up I guess?

>take key
Taken.

* * *

>unlock center hole with second key
You insert the key you found into the hole in the wall, and hear a slight click. You turn the key to the left like a total dimwit, but correct yourself before the key snaps and twist the other direction. A small section of the wall eases forward with a sigh, revealing a passageway east.

>e
You push open the rocky door and move onwards through a short passageway.

Library
You arrive in a long room full of thousands and thousands of bookshelves, full to the brim with dust-covered tomes. An ancient library, with books on topics much to complex for you to understand. The shelves continue further south.

Behind you to the west, you see a rocky door in the wall.

To the east you see a thick metal door, its industrial design a strange contrast to the otherwise ancient design you've encountered in this world so far. Extruded from the door is a box labeled "KEY", apparently held closed by a 2-digit combination lock, which is a little odd for state-of-the-art security.

>s
Library (Shelf #1)
This section of the library is much the same as all the rest: shelves of books to either side, untouched books lying on their shelves.

Lying on the shelf to your left, a dustless green tome lies on its side. Gold lettering on its spine reads "THE DIALOGUES OF PLATO." Lower down, its call number is printed: 184.2.

Standing on the right shelf, a tome with a suspicious amount of dust rests on the right shelf. Silver lettering on its spine reads "THE GREAT TRANSFORMATION," and below that its call number is written "200.9."

>s
Library (Shelf #2)
This section of the library is much the same as all the rest: shelves of books to either side, untouched books lying on their shelves.

Directly in front of you, a white novel rests on the ground. Black type on its cover reads "Outliers." On its spine a call number is printed: 302.6.

Peeking over the edge of the right shelf, a yellow book hangs above your head face-down. From where you stand, you can see bold black-and-blue lettering, "Because Internet." On its spine, a call number reads "402.231."

>x because internet
4ll 4b0u7 7h3 1mp4c75 0f 7h3 w0rld w1d3 w3b 0n m0d3rn 3n6l15h l1n6u1571c5. fr0m c0mmun17y 5p3c1f1c j4r60n, 70 63n3r4l c0mm3n7 57ruc7ur35, 70 l4n6u4635 l1k3 l337 5p34k, 7h3 1n73rn37 h45 pr0f0undly 5h4p3d h0w w3 c0mmun1c473 - ch4n61n6 fr0m pl47f0rm 70 pl47f0rm, r00m 70 n3x7 r00m.

Title: Because Internet: Understanding the New Rules of Language
Call number: 402.231

* * *

>search couch
You search throughout the couch lazily and find only crumbs. You could scoop them up I guess?

>take crumbs
Taken.

>search couch
You search under the couch and under the cushions, and find a small key hiding underneath.

>search couch
You search under the couch and under the cushions, and find a small key hiding underneath.

>take key
Taken.

>search couch
You search under the couch and under the cushions, and find... nothing.

>drop key and crumbs
first key: Dropped.
crumbs: Dropped.

>search couch
You search under the couch and under the cushions, and find a mountain of crumbs and a small key hiding underneath.

>take crumbs and key
crumbs: Taken.
first key: Taken.

* * *

>can i skip
Ok.

    *** The End ***

Would you like to RESTART, RESTORE a saved game, QUIT or UNDO the last command?

>undo
Great Room
[Previous turn undone.]

>win
Ok.

    *** The End ***

Would you like to RESTART, RESTORE a saved game, QUIT or UNDO the last command?

>undo
Great Room
[Previous turn undone.]

>solve the puzzles
Ok.

    *** The End ***

Would you like to RESTART, RESTORE a saved game, QUIT or UNDO the last command?

>undo
Great Room
[Previous turn undone.]

>beat the game
Ok.

    *** The End ***

Would you like to RESTART, RESTORE a saved game, QUIT or UNDO the last command?

>undo
Great Room
[Previous turn undone.]

* * *

>can i win
Ok.

    *** The End ***

Would you like to RESTART, RESTORE a saved game, QUIT or UNDO the last command?

>undo
Great Room
[Previous turn undone.]

* * *

>e
(first opening Door with Eight Locks)
It seems to be locked.

>unlock door with eight locks
(with Door with Eight Locks)
(first taking Door with Eight Locks)
That's hardly portable.

>un door
That's not a verb I recognise.

>unlock door
(with Door with Eight Locks)
(first taking Door with Eight Locks)
That's hardly portable.

* * *

>enter 21 to the metal door
You try to enter the code, but it's obviously not a combination lock and thus does not do anything.

* * *

>examine self
It's difficult to look at yourself without any mirror, and it's best not to think about it for too long or Ben will read your mind.

"Looks don't matter. What matters is that you're ugly on the inside."

Too late.

>w
Cluttered Room
You pass through the stone hallway, and step out in to the most cluttered room you've ever seen. You spin around, and bump into a tall stack of chairs. A snicker echoes from above, and you're reminded about how stupid this situation is.

You find yourself in a room, half the size of the previous room, filled to the brim with chairs, folded tables, closed crates, and smaller tidbits: rolled-up newspapers, stacks of loose paper, broken electronics, a Peloton, watches in a display case, a lamp, pots and pans, and other bits such items scattered about.

>s
Maze
You land in the next room just beyond the exit of the hallway, and the ground rumbles as it collapses behind you. You find yourself in what seems to be an ancient cobblestone maze. Rocks here and there seem to have fallen out of the wall over the ages it has stood in place, creating fist-sized holes in the walls. The path extends out to the east and west to either side.

>e
Library
Frustrated, you arrive in a room full of thousands and thousands of books. Just as the thought crosses your mind, you hear that voice again.

"It's not a room full of books, you imbecile. It's a library."

That would make sense.

>e
Mirror Maze
You slide the bottom of the tunnel, and immediately are confronted by... octopi. Hundreds of octopi in every direction. You leap to get out of the way and let out a high-pitched shriek.

The octopi ripple as a laugh shakes the room.

You look closer at the octopi and see... mirrors. Ben turned you into an octopus, and brought you to a mirror maze. Everywhere you look, octopi follow your gaze - eight tentacles sliding over the ground as you move.

>examine self
You're an octopus.

* * *

>feed pie
You can't see any such thing.

>w
Cluttered Room
You pass through the stone hallway, and step out in to the most cluttered room you've ever seen. You spin around, and bump into a tall stack of chairs like a moron.

You find yourself in a room, half the size of the previous room, filled to the brim with chairs, folded tables, closed crates, and smaller tidbits scattered about.

Behind you to the east you see a hallway, hewn out of the stone, leading  to another room.

To the south, almost obscured behind a large gray couch, you see a door.

To your right you see a dented bucket overflowing with junk. Or maybe it's important items for progressing in the game.

The couch, lying to your left in front of the door, sags with (fake) age, and it's got tears in the tattered fabric in some places.

>take pie
Taken.

>feed pie
(to yourself)
You can't give half-eaten pie to yourself.

>feed pie to fish
You can only do that to something animate.

* * *

>generate ink
That's not a verb I recognise.

>squirt ink
That's hardly portable.

>look
Great Room
A grand room built from giant blocks of a sand-colored stone, stacked up to a ceiling high above where a massive compass lays embedded in the rock. Before you to the east, taking up almost the entire wall, is a great metal door painted a deep blue and patterned with yellow and white veins that run throughout. At the base of the door are eight large keyholes. Back to the west you see a hallway, hewn out of the stone, leading to another room.

* * *

>go n
You can't go that way.

>go s
You can't go that way.

* * *

>go through door with eight locks
(first opening Door with Eight Locks)
It seems to be locked.

* * *

>go w
Cluttered Room
You pass through the stone hallway, and step out in to the most cluttered room you've ever seen. You spin around, and bump into a tall stack of chairs like a moron.

You find yourself in a room, half the size of the previous room, filled to the brim with chairs, folded tables, closed crates, and smaller tidbits scattered about.

Behind you to the east you see a hallway, hewn out of the stone, leading  to another room.

To the south, almost obscured behind a large gray couch, you see a door.

To your right you see a dented bucket overflowing with junk. Or maybe it's important items for progressing in the game.

The couch, lying to your left in front of the door, sags with (fake) age, and it's got tears in the tattered fabric in some places.

>bgo s
That's not a verb I recognise.

>s
Maze
You land in the next room just beyond the exit of the hallway, and the ground rumbles as it collapses behind you. You find yourself in what seems to be an ancient cobblestone maze. Rocks here and there seem to have fallen out of the wall over the ages it has stood in place, creating fist-sized holes in the walls. The path extends out to the east and west to either side. To the east you see a hallway continuing into the next room.

On the wall is a giant sign that says "PUZZLE INOPERABLE."

>e
Library
Frustrated, you arrive in a room full of thousands and thousands of books. Just as the thought crosses your mind, you hear that voice again.

"It's not a room full of books, you imbecile. It's a library."

That would make sense. To the east you see a hallway continuing into the next room.

On the wall is a giant sign that says "PUZZLE INOPERABLE."

>e
Mirror Maze
You slide the bottom of the tunnel, and immediately are confronted by... octopi. Hundreds of octopi in every direction. You leap to get out of the way and let out a high-pitched shriek.

The octopi ripple as a laugh shakes the room.

You look closer at the octopi and see... mirrors. Boaz turned you into an octopus, and brought you to a mirror maze. Everywhere you look, octopi follow your gaze - eight tentacles sliding over the ground as you move. To the north you see a hallway continuing into the next room.

On the wall is a giant sign that says "PUZZLE INOPERABLE."

>n
Aquarium
As you adjust to the realization that you're now a cephalapod, you move into the next room. You find yourself in a clean, black-floored room with fish tanks on either side. From your position, you can see a key taped to the ceiling. To the north you see a hallway continuing into the next room.

On the wall is a giant sign that says "PUZZLE INOPERABLE."

>s
Mirror Maze
You're surrounded by a mirror maze. Everywhere you look, octopi follow your gaze - eight tentacles sliding over the ground as you move. To the north you see a hallway continuing into the next room.

On the wall is a giant sign that says "PUZZLE INOPERABLE."

>x self
You're an octopus.

* * *

>go s
Maze
You land in the next room just beyond the exit of the hallway, and the ground rumbles as it collapses behind you. You find yourself in what seems to be an ancient cobblestone maze. Rocks here and there seem to have fallen out of the wall over the ages it has stood in place, creating fist-sized holes in the walls. The path extends out to the east and west to either side. To the east you see a hallway continuing into the next room.

On the wall is a giant sign that says "PUZZLE INOPERABLE."

>go e
Library
Frustrated, you arrive in a room full of thousands and thousands of books. Just as the thought crosses your mind, you hear that voice again.

"It's not a room full of books, you imbecile. It's a library."

That would make sense. To the east you see a hallway continuing into the next room.

On the wall is a giant sign that says "PUZZLE INOPERABLE."

>go e
Mirror Maze
You slide the bottom of the tunnel, and immediately are confronted by... octopi. Hundreds of octopi in every direction. You leap to get out of the way and let out a high-pitched shriek.

The octopi ripple as a laugh shakes the room.

You look closer at the octopi and see... mirrors. Ben turned you into an octopus, and brought you to a mirror maze. Everywhere you look, octopi follow your gaze - eight tentacles sliding over the ground as you move. To the north you see a hallway continuing into the next room.

On the wall is a giant sign that says "PUZZLE INOPERABLE."

>go n
Aquarium
As you adjust to the realization that you're now a cephalapod, you move into the next room. You find yourself in a clean, black-floored room with fish tanks on either side. From your position, you can see a key taped to the ceiling. To the north you see a hallway continuing into the next room.

On the wall is a giant sign that says "PUZZLE INOPERABLE."

>go n
Crash Lab
Not quite dry yet, you proceed through the hallway and into the next room. Lying in the center of the room, you see a white car with a large kraken decal. To the west you see a hallway continuing into the next room.

On the wall is a giant sign that says "PUZZLE INOPERABLE."

>go w
Computer Lab
Shaken up from the crash, you move into the next room and are greeting by the familiar drone of computer fans. In front of you, you can see three rows of computers. All of them are off (so it's kind of weird that the fans are so loud), except for one computer directly to your left. To the west you see a hallway continuing into the next room.

On the wall is a giant sign that says "PUZZLE INOPERABLE."

>go w
Room of Keys
You walk through the hallway and feel a sharp pain in your fee... tentacles. Looking down, you see a regular, almost boring room with one small difference: the entire floor is covered in silver keys. Lying in a bag labeled "DOORKEYS" are eight dark-gray doorkeys. To the southeast you see a hallway continuing into the next room.

>go se
Great Room
A grand room built from giant blocks of a sand-colored stone, stacked up to a ceiling high above where a massive compass lays embedded in the rock. Back to the west you see a hallway, hewn out of the stone, leading to another room.

Before you to the east, taking up almost the entire wall, is a great metal door painted a deep blue and patterned with yellow and white veins that run throughout. At the base of the door are eight large keyholes.

>go nw
Room of Keys
A regular, almost boring room with one small difference: the entire floor is covered in silver keys. Lying in a bag labeled "DOORKEYS" are eight dark-gray doorkeys. To the southeast you see a hallway continuing into the next room.

>take doorkeys
doorkey: Taken.
doorkey: Taken.
doorkey: Taken.
doorkey: Taken.
doorkey: Taken.
doorkey: Taken.
doorkey: Taken.
doorkey: Taken.

>go se
Great Room
A grand room built from giant blocks of a sand-colored stone, stacked up to a ceiling high above where a massive compass lays embedded in the rock. Back to the west you see a hallway, hewn out of the stone, leading to another room.

Before you to the east, taking up almost the entire wall, is a great metal door painted a deep blue and patterned with yellow and white veins that run throughout. At the base of the door are eight large keyholes.

>unlock door
(with the doorkey)
With a key in each tentacle, you reach up toward the keyholes and rotate the keys. The door clicks open and Ben's voice echoes through the room:

"Mkay listen here the puzzles weren't finished so I removed them from this version but I'm working on making them not suck before I actually show you them but they'll be ready by Monday and I'll put them in this folder."

    *** The End ***

Would you like to RESTART, RESTORE a saved game, QUIT or UNDO the last command?

* * *

>go e
Mirror Maze
You slide the bottom of the tunnel, and immediately are confronted by... octopi. Hundreds of octopi in every direction. You leap to get out of the way and let out a high-pitched shriek.

The octopi ripple as a laugh shakes the room.

You look closer at the octopi and see... mirrors. Ben turned you into an octopus, and brought you to a mirror maze. Everywhere you look, octopi follow your gaze - eight tentacles sliding over the ground as you move. To the north you see a hallway continuing into the next room.

On the wall is a giant sign that says "PUZZLE INOPERABLE."

>n
Aquarium
As you adjust to the realization that you're now a cephalapod, you move into the next room. You find yourself in a clean, black-floored room with fish tanks on either side. From your position, you can see a key taped to the ceiling. To the north you see a hallway continuing into the next room.

>n
Crash Lab
Not quite dry yet, you proceed through the hallway and into the next room. Lying in the center of the room, you see a white car with a large kraken decal. To the west you see a hallway continuing into the next room.

>w
Computer Lab
Shaken up from the crash, you move into the next room and are greeting by the familiar drone of computer fans. In front of you, you can see three rows of computers. All of them are off (so it's kind of weird that the fans are so loud), except for one computer directly to your left. To the west you see a hallway continuing into the next room.

>w
Room of Keys
You walk through the hallway and feel a sharp pain in your fee... tentacles. Looking down, you see a regular, almost boring room with one small difference: the entire floor is covered in silver keys. Lying in a bag labeled "DOORKEYS" are eight dark-gray doorkeys. To the southeast you see a hallway continuing into the next room.

>take keys
You can't see any such thing.

>se
Great Room
A grand room built from giant blocks of a sand-colored stone, stacked up to a ceiling high above where a massive compass lays embedded in the rock. Back to the west you see a hallway, hewn out of the stone, leading to another room.

Before you to the east, taking up almost the entire wall, is a great metal door painted a deep blue and patterned with yellow and white veins that run throughout. At the base of the door are eight large keyholes.

>nw
You can't go that way.

* * *

>go s
Maze
You land in the next room just beyond the exit of the hallway, and the ground rumbles as it collapses behind you. You find yourself in what seems to be an ancient cobblestone maze. Rocks here and there seem to have fallen out of the wall over the ages it has stood in place, creating fist-sized holes in the walls. The path extends out to the east and west to either side. To the east you see a hallway continuing into the next room.

On the wall is a giant sign that says "PUZZLE INOPERABLE."

>go s
You can't go that way.

>go e
Library
Frustrated, you arrive in a room full of thousands and thousands of books. Just as the thought crosses your mind, you hear that voice again.

"It's not a room full of books, you imbecile. It's a library."

That would make sense.

>go e
Mirror Maze
You slide the bottom of the tunnel, and immediately are confronted by... octopi. Hundreds of octopi in every direction. You leap to get out of the way and let out a high-pitched shriek.

The octopi ripple as a laugh shakes the room.

You look closer at the octopi and see... mirrors. Ben turned you into an octopus, and brought you to a mirror maze. Everywhere you look, octopi follow your gaze - eight tentacles sliding over the ground as you move.

>go s
You can't go that way.

>go n
Aquarium
As you adjust to the realization that you're now a cephalapod, you move into the next room. You find yourself in a clean, black-floored room with fish tanks on either side. From your position, you can see a key taped to the ceiling.

>go n
Crash Lab
Not quite dry yet, you proceed through the hallway and into the next room. Lying in the center of the room, you see a white car with a large kraken decal.

>go e
You can't go that way.

>go w
Computer Lab
Shaken up from the crash, you move into the next room and are greeting by the familiar drone of computer fans. In front of you, you can see three rows of computers. All of them are off (so it's kind of weird that the fans are so loud), except for one computer directly to your left.

>go w
Room of Keys
You walk through the hallway and feel a sharp pain in your fee... tentacles. Looking down, you see a regular, almost boring room with one small difference: the entire floor is covered in silver keys.

Lying in a bag labeled "DOORKEYS" are eight dark-gray keys.

>take key
You can't see any such thing.

>take doorkey
Taken.

* * *

>go n
Crash Lab
Not quite dry yet, you proceed through the hallway and into the next room. Lying in the center of the room, you see a white car with a large kraken decal.

>go n
You can't go that way.

>go w
Computer Lab
Shaken up from the crash, you move into the next room and are greeting by the familiar drone of computer fans. In front of you, you can see three rows of computers. All of them are off (so it's kind of weird that the fans are so loud), except for one computer directly to your left.

>go w
Room of Keys
You walk through the hallway and feel a sharp pain in your fee... tentacles. Looking down, you see a regular, almost boring room with one small difference: the entire floor is covered in silver keys. Lying in a bag labeled "DOORKEYS" are eight dark-gray doorkeys.

>take doorkeys
doorkey: Taken.
doorkey: Taken.
doorkey: Taken.
doorkey: Taken.
doorkey: Taken.
doorkey: Taken.
doorkey: Taken.
doorkey: Taken.

>go sw
You can't go that way.

>go se
Great Room
A grand room built from giant blocks of a sand-colored stone, stacked up to a ceiling high above where a massive compass lays embedded in the rock. Back to the west you see a hallway, hewn out of the stone, leading to another room.

Before you to the east, taking up almost the entire wall, is a great metal door painted a deep blue and patterned with yellow and white veins that run throughout. At the base of the door are eight large keyholes.

>unlock door
(with the doorkey)
Bitch

* * *

>go s
Maze
You land in the next room just beyond the exit of the hallway, and the ground rumbles as it collapses behind you. You find yourself in what seems to be an ancient cobblestone maze. Rocks here and there seem to have fallen out of the wall over the ages it has stood in place, creating fist-sized holes in the walls. The path extends out to the east and west to either side. To the east you see a hallway continuing into the next room.

On the wall is a giant sign that says "PUZZLE INOPERABLE."

>look
Maze
An ancient cobblestone maze. Rocks here and there seem to have fallen out of the wall over the ages it has stood in place, creating fist-sized holes in the walls. The path extends out to the east and west to either side.

>n
You can't go that way.

>s
You can't go that way.

>e
The Library

>w
Maze
An ancient cobblestone maze. Rocks here and there seem to have fallen out of the wall over the ages it has stood in place, creating fist-sized holes in the walls. The path extends out to the east and west to either side.

* * *

>look
Cluttered Room
A room, half the size of the previous room, filled to the brim with chairs, folded tables, closed crates, and smaller tidbits: rolled-up newspapers, stacks of loose paper, broken electronics, a Peloton, watches in a display case, a lamp, pots and pans, and other bits such items scattered about.

>x newspaper
You see nothing special about 5 newspapers.

>take newspaper
That's hardly portable.

* * *

>search couch
You search throughout the couch lazily and find only crumbs. You could scoop them up I guess?
Though you've never been the best finder-of-things, particularly due to your atrocious eyesight and generally dreadful organization, but you think that the couch has crumbs.

* * *

>wear bucket
You put the bucket on your head, and clearly have underestimated its size - half of your vision is obscured by the giant tin hat you're now wearing. I hope it's uncomfortable.

(first taking the bucket)
You put on the bucket.

>s
Maze
You land in the next room just beyond the exit of the hallway, and the ground rumbles as it collapses behind you. You find yourself in what seems to be an ancient cobblestone maze. Rocks here and there seem to have fallen out of the wall over the ages it has stood in place, creating fist-sized holes in the walls. The path extends out to the east and west to either side. To the east you see a hallway continuing into the next room.

On the wall is a giant sign that says "PUZZLE INOPERABLE."

* * *

>e
Mirror Maze
You slide the bottom of the tunnel, and immediately are confronted by... octopi. Hundreds of octopi in every direction. You leap to get out of the way and let out a high-pitched shriek.

The octopi ripple as a laugh shakes the room.

You look closer at the octopi and see... mirrors. Boaz turned you into an octopus, and brought you to a mirror maze. Everywhere you look, octopi follow your gaze - eight tentacles sliding over the ground as you move. To the north you see a hallway continuing into the next room.

On the wall is a giant sign that says "PUZZLE INOPERABLE."

>x self
You're an octopus wearing a bucket.

* * *

>x bucket
A medium-sized tin bucket, paint peeling from use. Or probably not, because this world doesn't really exist and Boaz made it up.

In the bucket is an umbrella.

>x umbrella
A blue-and-white umbrella with a worn wooden handle. One of the spokes is bent inwards, because the umbrella is bad.

>take umbrella
Taken.

>take bucket
Taken.

>wear bucket
You put the bucket on your head, and clearly have underestimated its size - half of your vision is obscured by the giant tin hat you're now wearing. I hope it's uncomfortable.

You put on the bucket.

>i
You are carrying:
  a bucket (being worn)
  an umbrella

>examine
What do you want to examine?

>x self
It's difficult to look at yourself without a mirror, and it's best not to think about it for too long or Boaz will read your mind.

"Looks don't matter. What matters is that you're ugly on the inside.
 And the bucket doesn't help"

Too late.

* * *

>gw
That's not a verb I recognise.

>w
Cluttered Room
You pass through the stone hallway, and step out in to the most cluttered room you've ever seen. You spin around, and bump into a tall stack of chairs. A snicker echoes from above, and you're reminded about how stupid this situation is.

You find yourself in a room, half the size of the previous room, filled to the brim with chairs, folded tables, closed crates, and smaller tidbits: rolled-up newspapers, stacks of loose paper, broken electronics, a Peloton, watches in a display case, a lamp, pots and pans, and other bits such items scattered about. To the south, almost obscured behind two stacked couches, you see door.

test

* * *

>help
That's not a verb I recognise.

* * *

>look
Great Room
A grand room built from giant blocks of a sand-colored stone, stacked up to a ceiling high above where a massive compass lays embedded in the rock. Back to the west you see a hallway, hewn out of the stone, leading to another room.

Before you to the east, taking up almost the entire wall, is a great metal door painted a deep blue and patterned with yellow and white veins that run throughout. At the base of the door are eight large keyholes.

>look at door
Taking a closer look at the door, you see the flakes of paint chipping off with age, little smudges where the painter's brush slipped, a little mark of their humanity. Unless, actually, they're not human - given that this is a dimension dreamed up by a vengeful wizard

>go w
Cluttered Room
You pass through the stone hallway, and step out in to the most cluttered room you've ever seen. You spin around, and bump into a tall stack of chairs. A snicker echoes from above, and you're reminded about how stupid this situation is.

You find yourself in a room, half the size of the previous room, filled to the brim with chairs, folded tables, closed crates, and smaller tidbits: rolled-up newspapers, stacks of loose paper, broken electronics, a Peloton, watches in a display case, a lamp, pots and pans, and other bits such items scattered about.

* * *

>n
penis
penis

>s
You can't go that way.

* * *

>purloin
What do you want to purloin?

>purloin the first key
[Purloined.]

>i
You are carrying:
  the first key

>insert first key into first keyhole
You put the first key into the first keyhole.

>look door
Which do you mean, the small blue door or Final Door?

>look final door
Taking a closer look at the door, you see the flakes of paint chipping off with age, little smudges where the painter's brush slipped, a little mark of their humanity. Unless, actually, they're not human - given that this is a dimension dreamed up by a vengeful wizard.
In the first keyhole is a small silver key.

>purloin the second key and the third key and the fourth key
[Purloined.]
[Purloined.]
[Purloined.]

>insert second key into second keyhole
You put the second key into the second keyhole.

>look
Great Room
A grand room built from giant blocks of a sand-colored stone, stacked up to a ceiling high above where a massive compass lays embedded in the rock.

To the south, a small blue door is embedded in the rock.

Behind you to the west you see a hallway, hewn out of the stone, leading  to another room.

Before you to the east, taking up almost the entire wall, is a great metal door painted a deep blue and patterned with yellow and white veins that run throughout. At the base of the door are four keyholes and four doorknobs.
In the first keyhole is a small silver key.
In the second keyhole is a small silver key.

>look final door
Taking a closer look at the door, you see the flakes of paint chipping off with age, little smudges where the painter's brush slipped, a little mark of their humanity. Unless, actually, they're not human - given that this is a dimension dreamed up by a vengeful wizard.
In the first keyhole is a small silver key.
In the second keyhole is a small silver key.

* * *

>s
(first opening the fourth door)
It seems to be locked.

>n
You can't go that way.

>w
Cluttered Room
You pass through the stone hallway, and step out in to the most cluttered room you've ever seen. You spin around, and bump into a tall stack of chairs like a moron.

You find yourself in a room, half the size of the previous room, filled to the brim with chairs, folded tables, closed crates, and smaller tidbits scattered about.

Behind you to the east you see a hallway, hewn out of the stone, leading  to another room.

To the south, almost obscured behind a large gray couch, you see a door.

To your right you see a dented bucket overflowing with junk. Or maybe it's important items for progressing in the game.

The couch, lying to your left in front of the door, sags with (fake) age, and it's got tears in the tattered fabric in some places.

>e
Great Room
A grand room built from giant blocks of a sand-colored stone, stacked up to a ceiling high above where a massive compass lays embedded in the rock.

Behind you to the west you see a hallway, hewn out of the stone, leading  to another room.

Before you to the east, taking up almost the entire wall, is a great metal door painted a deep blue and patterned with yellow and white veins that run throughout. At the base of the door are eight large keyholes.

* * *

>x bucket
A medium-sized tin bucket, paint peeling from use. Or probably not, because this world doesn't really exist and I made it up.

In the bucket are an umbrella, skull, suspicious rag, half-eaten pie, rare great hornd bath towl cat, anime figurine, stack of sticky notes and the angry fish.

>take angry fisj
You can't see any such thing.

>take angry fish
You can't see any such thing.

>x angry fish
You can't see any such thing.

>x fish
You see nothing special about the angry fish.

* * *

>s
(first opening the fourth door)
It seems to be locked.

>w
Cluttered Room
You pass through the stone hallway, and step out in to the most cluttered room you've ever seen. You spin around, and bump into a tall stack of chairs like a moron.

You find yourself in a room, half the size of the previous room, filled to the brim with chairs, folded tables, closed crates, and smaller tidbits scattered about.

Behind you to the east you see a hallway, hewn out of the stone, leading  to another room.

To the south, almost obscured behind a large gray couch, you see a door.

To your right you see a dented bucket overflowing with junk. Or maybe it's important items for progressing in the game.

The couch, lying to your left in front of the door, sags with (fake) age, and it's got tears in the tattered fabric in some places.

>search couch
You look through the couch, and find nothing. I made the couch bigger on the inside than the outside, so it's extra hard to find anything hiding inside.

>search couch
You look through the couch, and find nothing. I made the couch bigger on the inside than the outside, so it's extra hard to find anything hiding inside.

>search couch
You search under the couch and under the cushions, and find a small key hiding underneath.

* * *

>unlock door with key
You unlock the first door.

>s
(first opening the first door)

Cobble Wall
You push through the door, and find yourself in a thin, wide room that ends abruptly in front you in an ancient cobblestone wall. The wall stretches up high above, ending just before the ceiling. Rocks here and there seem to have fallen out of the wall over the ages it has stood in place, creating holes of varying sizes in the walls (though as I believe I've made clear, it's not actually ancient because it's fake so the holes have been there since I created it).

To the north you can see the door you came through earlier.

You can also see fist-sized hole here.

>go through hole
Cave of Shame
You squeeze yourself through the hole with surprising ease, but due to your inability to do anything properly you cause the entrance to cave in behind you. You find yourself in a bare cave, no larger than a fist. Once again, you're puzzled on how you fit.

You can see fist-sized hole here.

* * *

>squirt ink
That's hardly portable.

>go n
You can't go that way.

* * *

>squirt ink
That's hardly portable.

>i
You are carrying:
  knife

* * *

>look
Great Room
A grand room built from giant blocks of a sand-colored stone, stacked up to a ceiling high above where a massive compass lays embedded in the rock. Before you to the east, taking up almost the entire wall, is a great metal door painted a deep blue and patterned with yellow and white veins that run throughout. At the base of the door are eight large keyholes. Back to the west you see a hallway, hewn out of the stone, leading to another room.

>take ink
That's hardly portable.

* * *

>squirt ink
That's hardly portable.

>make ink
Give the player ink somehow?

>poopoo
That's not a verb I recognise.

* * *

>take bucket
You can't see any such thing.

>w
Cluttered Room
You pass through the stone hallway, and step out in to the most cluttered room you've ever seen. You spin around, and bump into a tall stack of chairs. A snicker echoes from above, and you're reminded about how stupid this situation is.

You find yourself in a room, half the size of the previous room, filled to the brim with chairs, folded tables, closed crates, and smaller tidbits: rolled-up newspapers, stacks of loose paper, broken electronics, a Peloton, watches in a display case, a lamp, pots and pans, and other bits such items scattered about. To the south, almost obscured behind a large gray couch, you see door.

To your left you see a dented bucket overflowing with junk. Or maybe it's important items for progressing in the game.

The couch lying in front of the door sags with (fake) age, and it's got tears in the tattered fabric in some places.

>tacke bucket
That's not a verb I recognise.

>take bucket
That's fixed in place.

* * *

>take doorknob
You can't see any such thing.

>take first knob
Taken.

* * *

>take first knob
That's fixed in place.

>take first keyhole
That's fixed in place.

>take hidden utilities
That's hardly portable.

* * *

>take shoes
Taken.

* * *

>turn first knob
Nothing obvious happens.

* * *

>turn the first doorknob
You turn the first doorknob, and nothing happens. You don't appear to be able to turn this doorknob by itself.

>turn the second doorknob
You turn the second doorknob, and nothing happens. You don't appear to be able to turn this doorknob by itself.

>turn the third doorknob
You turn the third doorknob, and nothing happens. You don't appear to be able to turn this doorknob by itself.

>turn the fourth doorknob
You turn the fourth doorknob, and nothing happens. You don't appear to be able to turn this doorknob by itself.

* * *

>tw
That's not a verb I recognise.

>w
Cluttered Room
You pass through the stone hallway, and step out in to the most cluttered room you've ever seen. You spin around, and bump into a tall stack of chairs. A snicker echoes from above, and you're reminded about how stupid this situation is.

You find yourself in a room, half the size of the previous room, filled to the brim with chairs, folded tables, closed crates, and smaller tidbits: rolled-up newspapers, stacks of loose paper, broken electronics, a Peloton, watches in a display case, a lamp, pots and pans, and other bits such items scattered about.

>take newspaper
That's hardly portable.

>take lamp
That's hardly portable.

* * *

>unlock Final Door
What do you want to unlock Final Door with?

>unlock Final Door with keys
You can't see any such thing.

* * *

>unlock door
(with Door with Eight Locks)
(first taking Door with Eight Locks)
That's fixed in place.

>open door
It seems to be locked.

>open door with eight locks
It seems to be locked.

>i
You are carrying nothing.

>unlock door with eight locks
(with Door with Eight Locks)
(first taking Door with Eight Locks)
That's fixed in place.

* * *

>unlock door with tentacles
Which do you mean, the small blue door or the great metal door?

>unlock great metal door with tentacles
(first taking tentacles)
What?

>i
You are carrying nothing.

>w
Cluttered Room
You pass through the stone hallway, and step out in to the most cluttered room you've ever seen. You spin around, and bump into a tall stack of chairs like a moron.

You find yourself in a room, half the size of the previous room, filled to the brim with chairs, folded tables, closed crates, and smaller tidbits scattered about.

Behind you to the east you see a hallway, hewn out of the stone, leading  to another room.

To the south, almost obscured behind a large gray couch, you see a door.

To your right you see a dented bucket overflowing with junk. Or maybe it's important items for progressing in the game.

The couch, lying to your left in front of the door, sags with (fake) age, and it's got tears in the tattered fabric in some places.

>search couch
You search throughout the couch lazily and find only crumbs. You could scoop them up I guess?

>search couch
You search under the couch and under the cushions, and find a mountain of crumbs and a small key hiding underneath.

>take key and crumbs
silver key: Taken.
crumbs: Taken.

>look couch
On closer inspection, you realize that it's your couch. I stole it from the real world to put in my game. Looks like a good place to stash some stuff.

>unlock door with key
You unlock the square metal door.

>s
(first opening the square metal door)

Cobble Wall
You push through the door, and find yourself in a tiny room.

To the north you can see the door you came through earlier.

In the center of the wall to the east, you can see a hole as average as yourself. It's so normal it's disappointing.

To the southeast, you can see a miniscule hole, barely larger than your average United State dime, a ten-cent coin, one tenth of a United States dollar, labeled formally as "one dime". The denomination was first authorized by the Coinage Act of 1792. The dime is the smallest in diameter and is the thinnest of all U.S. coins currently minted for circulation, being 0.705 inches (17.91 millimeters) in diameter and 0.053 in (1.35 mm) in thickness. The hole is that size.

To the northeast, you see a hole roughly the size of a fist, punched through the rock in a feat of strength, possibly in frustration, possibly with this game.

To your left a cobblestone wall stretches up high above, ending just before the ceiling. Rocks here and there seem to have fallen out of the wall over the ages it has stood in place, creating holes of varying sizes throughout the surface.

>n
Cluttered Room
A room, half the size of the previous room, filled to the brim with chairs, folded tables, closed crates, and smaller tidbits scattered about.

To the south, almost obscured behind a large gray couch, you see a door.

Behind you to the east you see a hallway, hewn out of the stone, leading  to another room.

To your right you see a dented bucket overflowing with junk. Or maybe it's important items for progressing in the game.

The couch, lying to your left in front of the door, sags with (fake) age, and it's got tears in the tattered fabric in some places.

>take fish
Taken.

>s
Cobble Wall
A tiny room.

To the north you can see the door you came through earlier.

In the center of the wall to the east, you can see a hole as average as yourself. It's so normal it's disappointing.

To the southeast, you can see a miniscule hole, barely larger than your average United State dime, a ten-cent coin, one tenth of a United States dollar, labeled formally as "one dime". The denomination was first authorized by the Coinage Act of 1792. The dime is the smallest in diameter and is the thinnest of all U.S. coins currently minted for circulation, being 0.705 inches (17.91 millimeters) in diameter and 0.053 in (1.35 mm) in thickness. The hole is that size.

To the northeast, you see a hole roughly the size of a fist, punched through the rock in a feat of strength, possibly in frustration, possibly with this game.

To your left a cobblestone wall stretches up high above, ending just before the ceiling. Rocks here and there seem to have fallen out of the wall over the ages it has stood in place, creating holes of varying sizes throughout the surface.

>se
Teensy Cave of Fortune
Behind you to the northwest, light streams in from the puny cave's entrance.

In the dust below your feet, a small gold key glints in the dim light.

* * *

>unlock final door with tentacles
You can't see any such thing.

>take tentacles
Taken.

>unlock final door with tentacles
You can't see any such thing.

* * *

>unlock great metal door with tentacles
(first taking tentacles)
What?

* * *

>use tentacles to open great metal door
I didn't understand that sentence.

>use tentacles to unlock great metal door
I do believe those keyholes could use some work. Do you know how to use a door?

>unlock great metal door with tentacles
(first taking tentacles)
What?

* * *

>use tentacles to unlock final door
I do believe you are missing some keys there, my friend.

>w
Cluttered Room
You pass through the stone hallway, and step out in to the most cluttered room you've ever seen. You spin around, and bump into a tall stack of chairs like a moron.

You find yourself in a room, half the size of the previous room, filled to the brim with chairs, folded tables, closed crates, and smaller tidbits scattered about.

Behind you to the east you see a hallway, hewn out of the stone, leading  to another room.

To the south, almost obscured behind a large gray couch, you see a door.

To your right you see a dented bucket overflowing with junk. Or maybe it's important items for progressing in the game.

The couch, lying to your left in front of the door, sags with (fake) age, and it's got tears in the tattered fabric in some places.

>search couch
You search throughout the couch lazily and find only crumbs. You could scoop them up I guess?

Though you've never been the best finder-of-things, particularly due to your atrocious eyesight and generally dreadful searching ability, you think the couch has the crumbs.

>search couch
You search throughout the couch lazily and find only crumbs. You could scoop them up I guess?

Though you've never been the best finder-of-things, particularly due to your atrocious eyesight and generally dreadful searching ability, you think the couch has the crumbs.

>search couch
You search under the couch and under the cushions, and find a small key hiding underneath.

Though you've never been the best finder-of-things, particularly due to your atrocious eyesight and generally dreadful searching ability, you think the couch has the first key and the crumbs.

>take key and crumbs and fish
first key: Taken.
crumbs: Taken.
angry fish: Taken.

>unlock door with key
You unlock the first door.

>s
(first opening the first door)

Cobble Wall
You push through the door, and find yourself in a tiny room. To your left a cobblestone wall stretches up high above, ending just before the ceiling. Rocks here and there seem to have fallen out of the wall over the ages it has stood in place, creating holes of varying sizes throughout the surface.

To the north you can see the door you came through earlier.

In the center of the wall to the east, you can see a hole as average as yourself. It's so normal it's disappointing.

To the southeast, you can see a miniscule hole, barely larger than your average United State dime, a ten-cent coin, one tenth of a United States dollar, labeled formally as "one dime". The denomination was first authorized by the Coinage Act of 1792. The dime is the smallest in diameter and is the thinnest of all U.S. coins currently minted for circulation, being 0.705 inches (17.91 millimeters) in diameter and 0.053 in (1.35 mm) in thickness. The hole is that size.

To the northeast, you see a hole roughly the size of a fist, punched through the rock in a feat of strength, possibly in frustration, possibly with this game.

>se
Teensy Cave of Fortune
Behind you to the northwest, light streams in from the puny cave's entrance.

In the dust below your feet, a small silver key glints in the dim light.

* * *

>take key
(the second key)
Taken.

>nw
Cobble Wall
A tiny room. To your left a cobblestone wall stretches up high above, ending just before the ceiling. Rocks here and there seem to have fallen out of the wall over the ages it has stood in place, creating holes of varying sizes throughout the surface.

To the southeast, you can see a miniscule hole, barely larger than your average United State dime, a ten-cent coin, one tenth of a United States dollar, labeled formally as "one dime". The denomination was first authorized by the Coinage Act of 1792. The dime is the smallest in diameter and is the thinnest of all U.S. coins currently minted for circulation, being 0.705 inches (17.91 millimeters) in diameter and 0.053 in (1.35 mm) in thickness. The hole is that size.

To the north you can see the door you came through earlier.

In the center of the wall to the east, you can see a hole as average as yourself. It's so normal it's disappointing.

To the northeast, you see a hole roughly the size of a fist, punched through the rock in a feat of strength, possibly in frustration, possibly with this game.

>unlock center hole with second key
You insert the key you found into the hole in the wall, and hear a slight click. You turn the key to the left like a total dimwit, but correct yourself before the key snaps and twist the other direction. A small section of the wall eases forward with a sigh, revealing a passageway east.

>e
You push open the rocky door and move onwards through a short passageway.

Library
You arrive in a long room full of thousands and thousands of bookshelves, filled to the brim with dust-covered tomes. An ancient library, with books on topics much too complex for you to understand. The shelves continue further south.

Behind you to the west, you see a rocky door in the wall.

To the east you see a thick metal door, its industrial design a strange contrast to the otherwise ancient architecture you've encountered in this world so far.

Extruded from the door is a safe labeled "KEY", held closed by a 5-digit combination lock. There's a decimal point between the third and fourth digit of the number, which is odd for a combination lock.

>set lock to 594.56
The safe lid pops open with a rush of air as the seal is broken. Inside, you see the third key.

>take kery
You can't see any such thing.

>take key
(the third key)
Taken.

>unlock door with third key
You unlock the third door.

>e
(first opening the third door)

Aquarium
You push through the door, and find yourself in a drastically different room with plain concrete walls and a black floor flecked with gray spots. The ceiling looks basically the same as the walls from where you're standing, but between you and me, it's a "living roof" - a roof with a grass on top.

To the north, a door that almost looks like a miniature of the grand door from the Great Room - metal blue panels with white-and-yellow veins, square but capped by a glass half-circle on the top - is embedded in the rock.

To the west you see a thick metal door.

In the center of the room, taking up the majority of the space in the room is a giant fish tank. The first half meter of the tank is black glass, presumably hiding the inner workings of the tank. Above the base, the glass tank walls extend up for two meters. There does not appear to be a lid, but a sign next to the tank says in red, "NO MOLLUSCS IN THE TANK." Half submerged in the sand at the bottom of the fish tank, a small metal object glints and sparkles in the light.

>feed fish crumbs
(the angry fish the crumbs)
The fish, though hesitant at first, wolfs down the crumbs in a matter of seconds and wiggles happily. I'm sure it would be inclined to help you out if you ever needed anything fish-related.

>put fish in tank
(the happy fish in the fish tank)
You reach above the glass lip with a tentacle and drop the fish into the water. It gives you a little wink and dives to the bottom of the tank, dissappearing into the reef. A few seconds later, a pair of keys fly out of the water and hit you square between the eyes.

>unlock small door with fourth key
You can't see any such thing.

>unlock blue door with fourth key
You unlock the fourth door.

>n
(first opening the fourth door)

Great Room
A grand room built from giant blocks of a sand-colored stone, stacked up to a ceiling high above where a massive compass lays embedded in the rock.

To the south, a small blue door is embedded in the rock.

Behind you to the west you see a hallway, hewn out of the stone, leading  to another room.

Before you to the east, taking up almost the entire wall, is a great metal door painted a deep blue and patterned with yellow and white veins that run throughout. At the base of the door are four keyholes and four doorknobs.

>use tentacles to unlock final door
Fuck

* * *

>use tentacles to unlock the final door
I do believe those keyholes could use some work. Do you know how doors work?

* * *

>use tentacles to unlock the finaloor
You can't see any such thing.

>use tentacles to unlock the final door
I do believe those keyholes could use some work. Do you know how to use a door?

>s
(first opening the small blue door)
It seems to be locked.

>w
Cluttered Room
You pass through the stone hallway, and step out in to the most cluttered room you've ever seen. You spin around, and bump into a tall stack of chairs like a moron.

You find yourself in a room, half the size of the previous room, filled to the brim with chairs, folded tables, closed crates, and smaller tidbits scattered about.

Behind you to the east you see a hallway, hewn out of the stone, leading  to another room.

To the south, almost obscured behind a large gray couch, you see a door.

To your right you see a dented bucket overflowing with junk. Or maybe it's important items for progressing in the game.

The couch, lying to your left in front of the door, sags with (fake) age, and it's got tears in the tattered fabric in some places.

* * *

>w
Cluttered Room
You pass through the stone hallway, and step out in to the most cluttered room you've ever seen. You spin around, and bump into a tall stack of chairs like a moron.

You find yourself in a room, half the size of the previous room, filled to the brim with chairs, folded tables, closed crates, and smaller tidbits scattered about.

Behind you to the east you see a hallway, hewn out of the stone, leading  to another room.

To the south, almost obscured behind a large gray couch, you see a door.

To your right you see a dented bucket overflowing with junk. Or maybe it's important items for progressing in the game.

The couch, lying to your left in front of the door, sags with (fake) age, and it's got tears in the tattered fabric in some places.

>e
Great Room
A grand room built from giant blocks of a sand-colored stone, stacked up to a ceiling high above where a massive compass lays embedded in the rock.

Back to the west you see a hallway, hewn out of the stone, leading to another room.

Before you to the east, taking up almost the entire wall, is a great metal door painted a deep blue and patterned with yellow and white veins that run throughout. At the base of the door are eight large keyholes.

>w
Cluttered Room
A room, half the size of the previous room, filled to the brim with chairs, folded tables, closed crates, and smaller tidbits scattered about.

Back to the east you see a hallway, hewn out of the stone, leading to another room.

To the south, almost obscured behind a large gray couch, you see a closed door.

To your left you see a dented bucket overflowing with junk. Or maybe it's important items for progressing in the game.

The couch lying in front of the door sags with (fake) age, and it's got tears in the tattered fabric in some places.

>e
Great Room
A grand room built from giant blocks of a sand-colored stone, stacked up to a ceiling high above where a massive compass lays embedded in the rock.

Back to the west you see a hallway, hewn out of the stone, leading to another room.

Before you to the east, taking up almost the entire wall, is a great metal door painted a deep blue and patterned with yellow and white veins that run throughout. At the base of the door are eight large keyholes.

* * *

>w
Cluttered Room
A room, half the size of the previous room, filled to the brim with chairs, folded tables, closed crates, and smaller tidbits scattered about.

Back to the east you see a hallway, hewn out of the stone, leading to another room.

To the south, almost obscured behind a large gray couch, you see a closed door.

To your left you see a dented bucket overflowing with junk. Or maybe it's important items for progressing in the game.

The couch lying in front of the door sags with (fake) age, and it's got tears in the tattered fabric in some places.

>search couch
You search throughout the couch lazily and find only crumbs.
You could scoop them up I guess?

>take crumbs
Taken.

>search couch
You look through the couch, and find nothing. I made the couch bigger on the inside than the outside, so it's extra hard to find anything hiding inside.

* * *

>take key
Taken.

>look
Cluttered Room
A room, half the size of the previous room, filled to the brim with chairs, folded tables, closed crates, and smaller tidbits scattered about.

Back to the east you see a hallway, hewn out of the stone, leading to another room.

To the south, almost obscured behind a large gray couch, you see a closed door.

To your left you see a dented bucket overflowing with junk. Or maybe it's important items for progressing in the game.

The couch lying in front of the door sags with (fake) age, and it's got tears in the tattered fabric in some places.

>go through door
(first opening the first door)
It seems to be locked.

>unlock door
What do you want to unlock the first door with?

>unlock door with key
You unlock the first door.

>gos
That's not a verb I recognise.

>s
(first opening the first door)

Maze
You land in the next room just beyond the exit of the hallway, and the ground rumbles as it collapses behind you. You find yourself in what seems to be an ancient cobblestone maze. Rocks here and there seem to have fallen out of the wall over the ages it has stood in place, creating fist-sized holes in the walls. The path extends out to the east and west to either side. To the east you see a hallway continuing into the next room.

On the wall is a giant sign that says "PUZZLE INOPERABLE."

To the south, almost obscured behind a large gray couch, you see a closed door.

* * *

>look
Cluttered Room
A room, half the size of the previous room, filled to the brim with chairs, folded tables, closed crates, and smaller tidbits: rolled-up newspapers, stacks of loose paper, broken electronics, a Peloton, watches in a display case, a lamp, pots and pans, and other bits such items scattered about.

>take fuckassbitch
That's hardly portable.

>x fuckassbitch
You see nothing special about fuckassbitch.

* * *

>look
Cluttered Room
A room, half the size of the previous room, filled to the brim with chairs, folded tables, closed crates, and smaller tidbits: rolled-up newspapers, stacks of loose paper, broken electronics, a Peloton, watches in a display case, a lamp, pots and pans, and other bits such items scattered about.

>take newspaper
That's hardly portable.

* * *

>look
Cluttered Room
A room, half the size of the previous room, filled to the brim with chairs, folded tables, closed crates, and smaller tidbits: rolled-up newspapers, stacks of loose paper, broken electronics, a Peloton, watches in a display case, a lamp, pots and pans, and other bits such items scattered about.

>x fuckassbitch
You can't see any such thing.

* * *

>look
Cluttered Room
A room, half the size of the previous room, filled to the brim with chairs, folded tables, closed crates, and smaller tidbits: rolled-up newspapers, stacks of loose paper, broken electronics, a Peloton, watches in a display case, a lamp, pots and pans, and other bits such items scattered about.

>x newspaper
You see nothing special about the newspaper.

>x testicles
You can't see any such thing.

>take newspaper
That's hardly portable.

>penis fuck bitch i hate you
That's not a verb I recognise.

* * *

>look couch
On closer inspection, you realize that it's your couch. I stole it from the real world to put in my game. Looks like a good place to stash some stuff.

>search couch
You search throughout the couch lazily and find only crumbs. You could scoop them up I guess?

>search couch
You search throughout the couch lazily and find only crumbs. You could scoop them up I guess?

* * *

>look in couch
You search throughout the couch lazily and find only crumbs. You could scoop them up I guess?

>look in couch
You search under the couch and under the cushions, and find a small key hiding underneath.

* * *

>take key
(the second key)
Taken.

>n
You can't go that way.

>nw
Cobble Wall
A tiny room that ends abruptly to your left in an ancient cobblestone wall. The wall stretches up high above, ending just before the ceiling. Rocks here and there seem to have fallen out of the wall over the ages it has stood in place, creating holes of varying sizes in the walls (though as I believe I've made clear, it's not actually ancient because it's fake so the holes have been there since I created it).

To the southeast, you can see a miniscule hole, barely larger than your average United State dime, a ten-cent coin, one tenth of a United States dollar, labeled formally as "one dime". The denomination was first authorized by the Coinage Act of 1792. The dime is the smallest in diameter and is the thinnest of all U.S. coins currently minted for circulation, being 0.705 inches (17.91 millimeters) in diameter and 0.053 in (1.35 mm) in thickness. The hole looks like that.

To the north you can see the door you came through earlier.

In the center of the wall to the east, you can see a hole as average as yourself. It's so normal it's dissapointing.

In the northeast of the wall, you see a hole roughly the size of a fist, punched through the rock in a feat of strength far out of reach of one such as yourself.

>insert second key into center hole
You insert the key you found into the hole in the wall, and hear a slight click. You turn the key to the left like a total dimwit, but correct yourself before the key snaps and twist the other direction. A small section of the wall eases forward with a sigh, revealing a passageway east.

>e
You push open the rocky door and move onwards through a short passageway.

Library
You arrive in a long room full of thousands and thousands of bookshelves, full to the brim with dust-covered tomes. An ancient library, with books on topics much to complex for you to understand. The shelves continue further south.

Behind you to the west, you see a rocky door in the wall.

To the east you see a thick metal door, its industrial design a strange contrast to the otherwise ancient design you've encountered in this world so far.

Extruded from the door is a box labeled "KEY", held closed by a 5-digit combination lock, which is a little odd for state-of-the-art security. There's a decimal point three digits into the number, which is very odd for a combination lock.

>spin key box to 594.56
The key box lid pops open with a rush of air as the seal is broken. Inside, you see the third key.

>take key
(the key box)
That's fixed in place.

>take third key
Taken.

>unlock door with third key
You unlock the third door.

>e
(first opening the third door)

Mirror Maze
You slide the bottom of the tunnel, and immediately are confronted by... octopi. Hundreds of octopi in every direction. You leap to get out of the way and let out a high-pitched shriek.

The octopi ripple as a laugh shakes the room.

You look closer at the octopi and see... mirrors. Boaz turned you into an octopus, and brought you to a mirror maze. Everywhere you look, octopi follow your gaze - eight tentacles sliding over the ground as you move. To the north you see a hallway continuing into the next room.

On the wall is a giant sign that says "PUZZLE INOPERABLE."

To the west you see a thick metal door.

>w
Library
A great library, full to the brim with books. The shelves continue further south.

To the east you see a thick metal door, its industrial design a strange contrast to the otherwise ancient design you've encountered in this world so far.

Behind you to the west, you see a rocky door in the wall.

Extruded from the door is a box labeled "KEY", held closed by a 5-digit combination lock, which is a little odd for state-of-the-art security. There's a decimal point three digits into the number, which is very odd for a combination lock.

>e
Mirror Maze
You're surrounded by a mirror maze. Everywhere you look, octopi follow your gaze - eight tentacles sliding over the ground as you move. To the north you see a hallway continuing into the next room.

On the wall is a giant sign that says "PUZZLE INOPERABLE."

To the west you see a thick metal door.

* * *

>look in couch
You search throughout the couch lazily and find only crumbs. You could scoop them up I guess?

>take crumbs
Taken.

>look in couch
You search under the couch and under the cushions, and find a small key hiding underneath.

>look in couch
You search under the couch and under the cushions, and find a small key hiding underneath.

>look in couch
You look through the couch, and find nothing. I made the couch bigger on the inside than the outside, so it's extra hard to find anything hiding inside.

>look in couch
You look through the couch, and find nothing. I made the couch bigger on the inside than the outside, so it's extra hard to find anything hiding inside.

>look in couch
You search under the couch and under the cushions, and find a small key hiding underneath.

* * *

>take key
Taken.

>look in couch
You look through the couch, and find nothing. I made the couch bigger on the inside than the outside, so it's extra hard to find anything hiding inside.

>i
You are carrying:
  a first key
  some crumbs

* * *

>look in couch
You look through the couch, and find nothing. I made the couch bigger on the inside than the outside, so it's extra hard to find anything hiding inside.

>take key
Taken.

* * *

>unlock door with key
You unlock the first door.

>look in couch
You look through the couch, and find nothing. I made the couch bigger on the inside than the outside, so it's extra hard to find anything hiding inside.

* * *

>take key
Taken.

>look in couch
You search under the couch and under the cushions, and find a small key hiding underneath.

* * *

>look in couch
You search throughout the couch lazily and find only crumbs. You could scoop them up I guess?

>take key
Taken.

>s
(first opening the first door)
It seems to be locked.

>unlock door with key
You unlock the first door.

* * *

>e
You reach into the hole and try to fit through, but the hole seems to end abruptly in a cold metal surface. Odd.

>insert key into center hole
Which do you mean, the second key or the first key?

>insert second key into center hole
You insert the key you found into the hole in the wall, and hear a slight click. You turn the key to the left like a total dimwit, but correct yourself before the key snaps and twist the other direction. A small section of the wall eases forward with a sigh, revealing a passageway east.

* * *

>s
Library (Shelf #1)
This section of the library is much the same as all the rest: shelves of books to either side, untouched books lying on their shelves.

Lying on the shelf to your left, a dustless green tome lies on its side. Gold lettering on its spine reads "The Dialogues of Plato." Lower down, its call number is printed: 184.2.

Standing on the right shelf, a tome with a suspicious amount of dust rests on the right shelf. Silver lettering on its spine reads "The Great Transformation," and below that its call number is written "200.9."

* * *

>s
(first opening the first door)
It seems to be locked.

>e
Library
Frustrated, you arrive in a room full of thousands and thousands of books. Just as the thought crosses your mind, you hear that voice again.

"It's not a room full of books, you imbecile. It's a library."

That would make sense.

* * *

>e
Mirror Maze
You slide the bottom of the tunnel, and immediately are confronted by... octopi. Hundreds of octopi in every direction. You leap to get out of the way and let out a high-pitched shriek.

The octopi ripple as a laugh shakes the room.

You look closer at the octopi and see... mirrors. Ben turned you into an octopus, and brought you to a mirror maze. Everywhere you look, octopi follow your gaze - eight tentacles sliding over the ground as you move.

>e
You can't go that way.

>look
Mirror Maze
You're surrounded by a mirror maze. Everywhere you look, octopi follow your gaze - eight tentacles sliding over the ground as you move.

>examine self
It's probably best to focus on the task at hand.

>go w
You can't go that way.

* * *

>e
You can't go that way.

>n
Aquarium
As you adjust to the realization that you're now a cephalapod, you move into the next room. You find yourself in a clean, black-floored room with fish tanks on either side. From your position, you can see a key taped to the ceiling.

>n
Crash Lab
Not quite dry yet, you proceed through the hallway and into the next room. Lying in the center of the room, you see a white car with a large kraken decal.

>w
Computer Lab
Shaken up from the crash, you move into the next room and are greeting by the familiar drone of computer fans. In front of you, you can see three rows of computers. All of them are off (so it's kind of weird that the fans are so loud), except for one computer directly to your left.

>w
Room of Keys
You walk through the hallway and feel a sharp pain in your fee... tentacles. Looking down, you see a regular, almost boring room with one small difference: the entire floor is covered in silver keys.

Lying in a bag labeled "DOORKEYS" are eight dark-gray doorkeys.

>take doorkeys
doorkey: Taken.
doorkey: Taken.
doorkey: Taken.
doorkey: Taken.
doorkey: Taken.
doorkey: Taken.
doorkey: Taken.
doorkey: Taken.

>i
You are carrying:
  eight doorkeys

>go se
Great Room
A grand room built from giant blocks of a sand-colored stone, stacked up to a ceiling high above where a massive compass lays embedded in the rock. Back to the west you see a hallway, hewn out of the stone, leading to another room.

Before you to the east, taking up almost the entire wall, is a great metal door painted a deep blue and patterned with yellow and white veins that run throughout. At the base of the door are eight large keyholes.

>unlock door with eight doorkeys
I didn't understand that sentence.

>unlock door with eight locks with eight doorkeys
I didn't understand that sentence.

>unlock door with eight locks
(with the doorkey)
That doesn't seem to fit the lock.

>unlock door with eight locks
(with the doorkey)
That doesn't seem to fit the lock.

>i
You are carrying:
  eight doorkeys

>unlock door with eight locks
(with the doorkey)
That doesn't seem to fit the lock.

* * *

>e
Mirror Maze
You slide the bottom of the tunnel, and immediately are confronted by... octopi. Hundreds of octopi in every direction. You leap to get out of the way and let out a high-pitched shriek.

The octopi ripple as a laugh shakes the room.

You look closer at the octopi and see... mirrors. Ben turned you into an octopus, and brought you to a mirror maze. Everywhere you look, octopi follow your gaze - eight tentacles sliding over the ground as you move.

>examine self
It's probably best to focus on the task at hand.

* * *

>e
Library
Frustrated, you arrive in a room full of thousands and thousands of books. Just as the thought crosses your mind, you hear that voice again.

"It's not a room full of books, you imbecile. It's a library."

That would make sense.

>look
Library
A great library, full to the brim with boats.

* * *

>s
(first opening the first door)
It seems to be locked.

>s
You can't go that way.

>w
You can't go that way.

>e
Library
Frustrated, you arrive in a room full of thousands and thousands of books. Just as the thought crosses your mind, you hear that voice again.

"It's not a room full of books, you imbecile. It's a library."

That would make sense.

* * *

>e
Mirror Maze
You slide the bottom of the tunnel, and immediately are confronted by... octopi. Hundreds of octopi in every direction. You leap to get out of the way and let out a high-pitched shriek.

The octopi ripple as a laugh shakes the room.

You look closer at the octopi and see... mirrors. Ben turned you into an octopus, and brought you to a mirror maze. Everywhere you look, octopi follow your gaze - eight tentacles sliding over the ground as you move.

>look
Mirror Maze
You're surrounded by a mirror maze. Everywhere you look, octopi follow your gaze - eight tentacles sliding over the ground as you move.

>e
You can't go that way.

* * *

>s
(first opening the first door)
It seems to be locked.

>search couch
You search throughout the couch lazily and find only crumbs.
 You could scoop them up I guess?

>take crumbs
Taken.

* * *

>unlock door with key
You unlock the first door.

>s
(first opening the first door)

Maze
You land in the next room just beyond the exit of the hallway, and the ground rumbles as it collapses behind you. You find yourself in what seems to be an ancient cobblestone maze. Rocks here and there seem to have fallen out of the wall over the ages it has stood in place, creating fist-sized holes in the walls. The path extends out to the east and west to either side. To the east you see a hallway continuing into the next room.

On the wall is a giant sign that says "PUZZLE INOPERABLE."

To the south, almost obscured behind a large gray couch, you see a closed door.

* * *

>s couch
I only understood you as far as wanting to (go) s.

>search couch
You search under the couch and under the cushions, and find a small key hiding underneath.

* * *

>unlock door with key
You unlock the first door.

>s
(first opening the first door)

Cobble Wall
You push through the door, and find yourself in a thin, wide room that ends abruptly in front you in an ancient cobblestone wall. The wall stretches up high above, ending just before the ceiling. Rocks here and there seem to have fallen out of the wall over the ages it has stood in place, creating holes of varying sizes in the walls (though as I believe I've made clear, it's not actually ancient because it's fake so the holes have been there since I created it).

To the north you can see the door you came through earlier.

Directly in front of you - to the east, imbicile - you see a hole as average as yourself. It's so normal it's dissapointing.

To the southeast, you can see a miniscule hole, barely larger than your average United State dime, a ten-cent coin, one tenth of a United States dollar, labeled formally as "one dime". The denomination was first authorized by the Coinage Act of 1792. The dime is the smallest in diameter and is the thinnest of all U.S. coins currently minted for circulation, being 0.705 inches (17.91 millimeters) in diameter and 0.053 in (1.35 mm) in thickness. The hole looks like that.

In the northeast of the wall, you see a hole roughly the size of a fist, punched through the rock in a feat of strength far out of reach of one such as yourself.

>e
(first opening the center hole)
It seems to be locked.

>se
Teensy Cave of Fortune
Behind you to the northwest, light streams in from the tiny entrance.

You can also see the second key here.

* * *

>seach couch
That's not a verb I recognise.

>search couch
You search throughout the couch lazily and find only crumbs.
You could scoop them up I guess?

* * *

>take crumbs
Taken.

>eat crumbs
They're plainly inedible.

* * *

>search couch
You search throughout the couch lazily and find only crumbs. You could scoop them up I guess?

I beg your pardon?

I beg your pardon?

>search couch
You search under the couch and under the cushions, and find a small key hiding underneath.

Though you've never been the best finder-of-things, particularly due to your atrocious eyesight and generally dreadful searching ability, you think the couch has the first key and the crumbs.

>take key
Taken.

* * *

>insert second key into center hole
You insert the key you found into the hole in the wall, and hear a slight click. You turn the key to the left like a total dimwit, but correct yourself before the key snaps and twist the other direction. A small section of the wall eases forward with a sigh, revealing a passageway east.

>e
You push open the rocky door and move onwards through a short passageway.

Library
You arrive in a long room full of thousands and thousands of bookshelves, filled to the brim with dust-covered tomes. An ancient library, with books on topics much too complex for you to understand. The shelves continue further south.

Behind you to the west, you see a rocky door in the wall.

To the east you see a thick metal door, its industrial design a strange contrast to the otherwise ancient architecture you've encountered in this world so far.

Extruded from the door is a safe labeled "KEY", held closed by a 5-digit combination lock. There's a decimal point between the third and fourth digit of the number, which is odd for a combination lock.

* * *

>set lock to 594.56
The safe lid pops open with a rush of air as the seal is broken. Inside, you see the third key.

>take key
(the third key)
Taken.

* * *

>unlock door with third key
You unlock the third door.

>e
(first opening the third door)

Aquarium
You push through the door, and find yourself in a drastically different room with plain concrete walls and a black floor flecked with gray spots. The ceiling looks basically the same as the walls from where you're standing, but between you and me, it's a "living roof" - a roof with a grass on top.

To the west you see a thick metal door.

In the center of the room, taking up the majority of the space in the room is a giant fish tank. The first half meter of the tank is black glass, presumably hiding the inner workings of the tank. Above the base, the glass tank walls extend up for two meters. There does not appear to be a lid, but a sign next to the tank says in red, "NO MOLLUSCS IN THE TANK." Half submerged in the sand at the bottom of the fish tank, a small metal object glints and sparkles in the light.

>enter tank
You approach the tank, and scale the side with ease, slipping into the water within a matter of seconds. Suddenly, sirens go off, the room fills with a bright white light, and the water quakes furiously. Armored cars and tanks smash through the walls, and the ceiling splits open for soldiers to slide in on ropes hanging from helicopters above. You're yanked out of the water, and the soldiers slap cuffs on your tentacles as they take you away.

That was quite foolish of you. Can't you read?

    *** The End ***

Would you like to RESTART, RESTORE a saved game, QUIT or UNDO the last command?

>undo
Aquarium
[Previous turn undone.]

>look
Aquarium
A large room with plain concrete walls and a black floor flecked with gray spots. The ceiling looks basically the same as the walls from where you're standing, but between you and me, it's a "living roof" - a roof with a grass on top.

To the west you see a thick metal door.

In the center of the room, taking up the majority of the space in the room is a giant fish tank. The first half meter of the tank is black glass, presumably hiding the inner workings of the tank. Above the base, the glass tank walls extend up for two meters. There does not appear to be a lid, but a sign next to the tank says in red, "NO MOLLUSCS IN THE TANK." Half submerged in the sand at the bottom of the fish tank, a small metal object glints and sparkles in the light.

>i
You are carrying:
  the third key
  the second key
  a first key

>n
You can't go that way.

>w
Library
A great library, full to the brim with books. The shelves continue further south.

To the east you see a thick metal door, its industrial design a strange contrast to the otherwise ancient architecture you've encountered in this world so far.

Behind you to the west, you see a rocky door in the wall.

Extruded from the door is a safe labeled "KEY", held closed by a 5-digit combination lock. There's a decimal point between the third and fourth digit of the number, which is odd for a combination lock.

>w
You push open the rocky door and move onwards through a short passageway.

Library
A great library, full to the brim with books. The shelves continue further south.

To the east you see a thick metal door, its industrial design a strange contrast to the otherwise ancient architecture you've encountered in this world so far.

Behind you to the west, you see a rocky door in the wall.

Extruded from the door is a safe labeled "KEY", held closed by a 5-digit combination lock. There's a decimal point between the third and fourth digit of the number, which is odd for a combination lock.

>w
You push open the rocky door and move onwards through a short passageway.

Library
A great library, full to the brim with books. The shelves continue further south.

To the east you see a thick metal door, its industrial design a strange contrast to the otherwise ancient architecture you've encountered in this world so far.

Behind you to the west, you see a rocky door in the wall.

Extruded from the door is a safe labeled "KEY", held closed by a 5-digit combination lock. There's a decimal point between the third and fourth digit of the number, which is odd for a combination lock.

* * *

>search couch
You search throughout the couch lazily and find only crumbs. You could scoop them up I guess?

>eat crumbs
(first taking the crumbs)
You eat them, and are forever lowered in my eyes you disgusted being. You should be ashamed, for what you have done right now is irredeemable.

>i
You are carrying nothing.

>eat pie
You eat the pie. It's not bad for half-eaten pie from a bucket.

>i
You are carrying nothing.

>x bucket
A medium-sized tin bucket, paint peeling from use. Or probably not, because this world doesn't really exist and I made it up.

In the bucket are an umbrella, a skull, a suspicious rag, a half-eaten pie, a rare great hornd bath towl cat, an anime figurine, a stack of sticky notes and the angry fish.

* * *

>search couch
You search throughout the couch lazily and find only crumbs. You could scoop them up I guess?

>look in couch
You search under the couch and under the cushions, and find a small key hiding underneath.

* * *

>search couch
You search throughout the couch lazily and find only crumbs. You could scoop them up I guess?

>scoop crumbs
I only understood you as far as wanting to scoop.

* * *

>search couch
You search throughout the couch lazily and find only crumbs. You could scoop them up I guess?

>scoop up crumbs
Taken.

>search couch
You began searching with low expectations, but you still found a way to dissapoint.

Though you've never been the best finder-of-things, particularly due to your atrocious eyesight and generally dreadful searching ability, you think the couch has nothing.

>search couch
You began searching with low expectations, but you still found a way to dissapoint.

Though you've never been the best finder-of-things, particularly due to your atrocious eyesight and generally dreadful searching ability, you think the couch has nothing.

>search couch
You search under the couch and under the cushions, and find a small key hiding underneath.

Though you've never been the best finder-of-things, particularly due to your atrocious eyesight and generally dreadful searching ability, you think the couch has the first key.

>take key
Taken.

>look
Cluttered Room
A room, half the size of the previous room, filled to the brim with chairs, folded tables, closed crates, and smaller tidbits scattered about.

Behind you to the east you see a hallway, hewn out of the stone, leading  to another room.

To the south, almost obscured behind a large gray couch, you see a door.

To your right you see a dented bucket overflowing with junk. Or maybe it's important items for progressing in the game.

The couch, lying to your left in front of the door, sags with (fake) age, and it's got tears in the tattered fabric in some places.

>take fish
Taken.

>unlock door with key
You unlock the first door.

* * *

>set lock to 594.56
You can't see any such thing.

>set combination lock to 594.56
The safe lid pops open with a rush of air as the seal is broken. Inside, you see the third key.

>take key
(the third key)
Taken.

* * *

>unlock door with third key
You unlock the third door.

>e
(first opening the third door)

Aquarium
A large room with plain concrete walls and a black floor flecked with gray spots. The ceiling looks basically the same as the walls from where you're standing, but between you and me, it's a "living roof" - a roof with a grass on top.

To the west you see a thick metal door.

In the center of the room, taking up the majority of the space in the room is a giant fishtank. The first half meter of the tank is an black wall, presumably hiding the inner workings of the tank. Above the base, the glass tank walls extend up for two meters, where they end at a mesh lid.

>x fishtank
You can't see any such thing.

>x fish tank
In the fish tank is the fourth key.

* * *

>search couch
You search under the couch and under the cushions, and find a mountain of crumbs and a small key hiding underneath.

I beg your pardon?

>search couch
You search throughout the couch lazily and find only crumbs. You could scoop them up I guess?

* * *

>search couch
You search under the couch and under the cushions, and find a mountain of crumbs and a small key hiding underneath.

>take key and crumbs and fish
first key: Taken.
crumbs: Taken.
angry fish: Taken.

* * *

>set lock to 594.56
The safe lid pops open with a rush of air as the seal is broken. Inside, you see the third key.

>take krey
You can't see any such thing.

>take key
(the third key)
Taken.

* * *

>unlock door with third key
You unlock the third door.

>e
(first opening the third door)

Aquarium
You push through the door, and find yourself in a drastically different room with plain concrete walls and a black floor flecked with gray spots. The ceiling looks basically the same as the walls from where you're standing, but between you and me, it's a "living roof" - a roof with a grass on top.

To the north, a door that almost looks like a miniature of the grand door from the Great Room - metal blue panels with white-and-yellow veins - is embedded in the rock. In the Middle Eastern style, the top of the door is a semicircle.

To the west you see a thick metal door.

In the center of the room, taking up the majority of the space in the room is a giant fish tank. The bottom half meter of the tank is black glass, presumably hiding the inner workings of the tank. Above the base, the glass tank walls extend up for another two meters. There does not appear to be a lid, but a sign next to the tank says in red, "NO MOLLUSCS IN THE TANK." Half submerged in the sand at the bottom of the fish tank, a small metal object glints and sparkles in the light.

>feed fish the crumbs
(the angry fish the crumbs)
The fish, though hesitant at first, wolfs down the crumbs in a matter of seconds and wiggles happily. I'm sure it would be inclined to help you out if you ever needed anything fish-related.

>put fish in the tank
(the happy fish in the fish tank)
You reach above the glass lip with a tentacle and drop the fish into the water. It gives you a little wink and dives to the bottom of the tank, disappearing into the reef. A few seconds later a small silver key flies out of the water and hit you square between the eyes, falling to the floor.

>take key
(the fourth key)
Taken.

>unlock blue door
What do you want to unlock the small blue door with?

>unlock blue door with fourth key
You unlock the small blue door.

>n
(first opening the small blue door)

Great Room
A grand room built from giant blocks of a sand-colored stone, stacked up to a ceiling high above where a massive compass lays embedded in the rock.

To the south, a small blue door is embedded in the rock.

Behind you to the west you see a hallway, hewn out of the stone, leading  to another room.

Before you to the east, taking up almost the entire wall, is a great metal door painted a deep blue and patterned with yellow and white veins that run throughout. At the base of the door are four keyholes and four doorknobs.

>unlock final door with first key
You put the first key in the first keyhole. You turn it to the right, but it doesn't budge. You don't appear to be able to turn this key by itself.

>unlock final door
What do you want to unlock Final Door with?

>unlock final door with keys
You can't see any such thing.

>unlock final door with second key
You put the second key in the second keyhole. You turn it to the right, but it doesn't budge. You don't appear to be able to turn this key by itself.

>unlock big door with thir dkey
You can't see any such thing.

>unlock great door with third key
You put the third key in the third keyhole. You turn it to the right, but it doesn't budge. You don't appear to be able to turn this key by itself.

>unlock metal door with fourth key
You put the fourth key in the fourth keyhole. You turn it to the right, but it doesn't budge. You don't appear to be able to turn this key by itself.

>turn first doorknob
You turn the first doorknob, and nothing happens. You don't appear to be able to turn this doorknob by itself.

>use tentacles to unlock final door
You reach out with your tentacles, and grasp the four keys and four doorknobs. All at once, you turn them to the right. The great doors ease open with a slight creek as the world around you fades into a white nothingness, and you stand alone in a smooth plane. You against me.

I'll release you for now. If you bring me a present next year I might consider turning you back into a human.

    *** The End ***

Would you like to RESTART, RESTORE a saved game, QUIT or UNDO the last command?

* * *

>search couch
You search under the couch and under the cushions, and find a mountain of crumbs and a small key hiding underneath.

>scoop key and crumbs and fish
first key: Taken.
crumbs: Taken.
angry fish: Taken.

>take key and crumbs and fish
first key: Taken.
crumbs: Taken.
angry fish: Taken.

* * *

>scoop key and crumbs and fish
first key: Taken.
crumbs: Taken.
angry fish: Taken.

>unlock door with key
You unlock the first door.

* * *

>unlock center hole with second key
You insert the key you found into the hole in the wall, and hear a slight click. You turn the key to the left like a total dimwit, but correct yourself before the key snaps and twist the other direction. A small section of the wall eases forward with a sigh, revealing a passageway east.

>n
Cluttered Room
A room, half the size of the previous room, filled to the brim with chairs, folded tables, closed crates, and smaller tidbits scattered about.

To the south, almost obscured behind a large gray couch, you see a door.

Behind you to the east you see a hallway, hewn out of the stone, leading  to another room.

To your right you see a dented bucket overflowing with junk. Or maybe it's important items for progressing in the game.

The couch, lying to your left in front of the door, sags with (fake) age, and it's got tears in the tattered fabric in some places.

>s
Cobble Wall
A tiny room. To your left a cobblestone wall stretches up high above, ending just before the ceiling. Rocks here and there seem to have fallen out of the wall over the ages it has stood in place, creating holes of varying sizes throughout the surface.

To the north you can see the door you came through earlier.

To the southeast, you can see a miniscule hole, barely larger than your average United State dime, a ten-cent coin, one tenth of a United States dollar, labeled formally as "one dime". The denomination was first authorized by the Coinage Act of 1792. The dime is the smallest in diameter and is the thinnest of all U.S. coins currently minted for circulation, being 0.705 inches (17.91 millimeters) in diameter and 0.053 in (1.35 mm) in thickness. The hole is that size.

In the center of the wall to the east, you can see a hole as average as yourself. It's so normal it's disappointing.

To the northeast, you see a hole roughly the size of a fist, punched through the rock in a feat of strength, possibly in frustration, possibly with this game.

>e
You push open the rocky door and move onwards through a short passageway.

Library
You arrive in a long room full of thousands and thousands of bookshelves, filled to the brim with dust-covered tomes. An ancient library, with books on topics much too complex for you to understand. The shelves continue further south.

Behind you to the west, you see a rocky door in the wall.

To the east you see a thick metal door, its industrial design a strange contrast to the otherwise ancient architecture you've encountered in this world so far.

Extruded from the door is a safe labeled "KEY", held closed by a 5-digit combination lock. There's a decimal point between the third and fourth digit of the number, which is odd for a combination lock.

>w
(first opening the center hole)

Cobble Wall
A tiny room. To your left a cobblestone wall stretches up high above, ending just before the ceiling. Rocks here and there seem to have fallen out of the wall over the ages it has stood in place, creating holes of varying sizes throughout the surface.

In the center of the wall to the east, you can see a hole as average as yourself. It's so normal it's disappointing.

To the north you can see the door you came through earlier.

To the southeast, you can see a miniscule hole, barely larger than your average United State dime, a ten-cent coin, one tenth of a United States dollar, labeled formally as "one dime". The denomination was first authorized by the Coinage Act of 1792. The dime is the smallest in diameter and is the thinnest of all U.S. coins currently minted for circulation, being 0.705 inches (17.91 millimeters) in diameter and 0.053 in (1.35 mm) in thickness. The hole is that size.

To the northeast, you see a hole roughly the size of a fist, punched through the rock in a feat of strength, possibly in frustration, possibly with this game.

>e
You push open the rocky door and move onwards through a short passageway.

Library
A great library, full to the brim with books. The shelves continue further south.

Behind you to the west, you see a rocky door in the wall.

To the east you see a thick metal door, its industrial design a strange contrast to the otherwise ancient architecture you've encountered in this world so far.

Extruded from the door is a safe labeled "KEY", held closed by a 5-digit combination lock. There's a decimal point between the third and fourth digit of the number, which is odd for a combination lock.

>set lock to 594.56
The safe lid pops open with a rush of air as the seal is broken. Inside, you see the third key.

* * *

>w
Library
A great library, full to the brim with books. The shelves continue further south.

To the east you see a thick metal door, its industrial design a strange contrast to the otherwise ancient architecture you've encountered in this world so far.

Behind you to the west, you see a rocky door in the wall.

Extruded from the door is a safe labeled "KEY", held closed by a 5-digit combination lock. There's a decimal point between the third and fourth digit of the number, which is odd for a combination lock.

>e
Aquarium
A large room with plain concrete walls and a black floor flecked with gray spots. The ceiling looks basically the same as the walls from where you're standing, but between you and me, it's a "living roof" - a roof with a grass on top.

To the west you see a thick metal door.

In the center of the room, taking up the majority of the space in the room is a giant fish tank. The first half meter of the tank is black glass, presumably hiding the inner workings of the tank. Above the base, the glass tank walls extend up for two meters. There does not appear to be a lid, but a sign next to the tank says in red, "NO MOLLUSCS IN THE TANK." Half submerged in the sand at the bottom of the fish tank, a small metal object glints and sparkles in the light.

>feed fish the crumbs
(the angry fish the crumbs)
The fish, though hesitant at first, wolfs down the crumbs in a matter of seconds and wiggles happily. I'm sure it would be inclined to help you out if you ever needed anything fish-related.

>put fish in tank
(the happy fish in the fish tank)
You put the happy fish into the fish tank.

>x tank
A large glash fishtank that takes up most of the space in the room, and seems to be around two and a half meters tall. Half submerged in the sand at the bottom of the fish tank, a small metal object glints and sparkles in the light. A sign next to the tanks says in red, "NO MOLLUSCS IN THE TANK."

* * *

>search couch
You search under the couch and under the cushions, and find a mountain of crumbs and a small key hiding underneath.

>search couch
You search throughout the couch lazily and find only crumbs. You could scoop them up I guess?

* * *

I beg your pardon?

>search couch
You search throughout the couch lazily and find only crumbs. You could scoop them up I guess?

Though you've never been the best finder-of-things, particularly due to your atrocious eyesight and generally dreadful searching ability, you think the couch has the crumbs and the first key.

>search couch
You search throughout the couch lazily and find only crumbs. You could scoop them up I guess?

Though you've never been the best finder-of-things, particularly due to your atrocious eyesight and generally dreadful searching ability, you think the couch has the crumbs and the first key.

I beg your pardon?

* * *

>search couch
You search throughout the couch lazily and find only crumbs. You could scoop them up I guess?

Though you've never been the best finder-of-things, particularly due to your atrocious eyesight and generally dreadful searching ability, you think the couch has the crumbs and the first key.

>search couch
You search under the couch and under the cushions, and find a small key hiding underneath.

Though you've never been the best finder-of-things, particularly due to your atrocious eyesight and generally dreadful searching ability, you think the couch has the first key and the crumbs.

>search couch
You search under the couch and under the cushions, and find a small key hiding underneath.

Though you've never been the best finder-of-things, particularly due to your atrocious eyesight and generally dreadful searching ability, you think the couch has the first key and the crumbs.

* * *

>take key and crumbs and fish
first key: Taken.
crumbs: Taken.
angry fish: Taken.

>s
(first opening the first door)
It seems to be locked.

* * *

>put fish in tank
(the angry fish in the fish tank)
Failure.

>feed fish the crumbs
(the angry fish the crumbs)
The fish, though hesitant at first, wolfs down the crumbs in a matter of seconds and wiggles happily. I'm sure it would be inclined to help you out if you ever needed anything fish-related.

>put the happy fish in the fish tank
Success!

You put the happy fish into the fish tank.

>x tank
A large glash fishtank that takes up most of the space in the room, and seems to be around two and a half meters tall. Half submerged in the sand at the bottom of the fish tank, a small metal object glints and sparkles in the light. A sign next to the tanks says in red, "NO MOLLUSCS IN THE TANK."

The happy fish is swimming around happily, home at last.

* * *

>search couch
You search under the couch and under the cushions, and find a mountain of crumbs and a small key hiding underneath.

>search couch
You search throughout the couch lazily and find only crumbs. You could scoop them up I guess?

Though you've never been the best finder-of-things, particularly due to your atrocious eyesight and generally dreadful searching ability, you think the couch has the crumbs.

* * *

>se
Teensy Cave of Fortune
Behind you to the northwest, light streams in from the puny cave's entrance.

In the dust below your feet, a small silver key glints in the dim light.

>take ke
You can't see any such thing.

>take key
(the second key)
Taken.

* * *

>put fish in tank
(the happy fish in the fish tank)
You reach above the glass lip with a tentacle and drop the fish into the water. It gives you a little wink and dives to the bottom of the tank, dissappearing into the reef. A few seconds later, a pair of keys fly out of the water and hit you square between the eyes.

>unlock blue door with fourth key
You unlock the fourth door.

* * *

>n
(first opening the fourth door)

Great Room
A grand room built from giant blocks of a sand-colored stone, stacked up to a ceiling high above where a massive compass lays embedded in the rock.

To the south, a small blue door is embedded in the rock.

Behind you to the west you see a hallway, hewn out of the stone, leading  to another room.

Before you to the east, taking up almost the entire wall, is a great metal door painted a deep blue and patterned with yellow and white veins that run throughout. At the base of the door are four keyholes and four doorknobs.

>put first key in first keyhole
You put the first key into first keyhole.

>use tentacles to unlock final door
I do believe those keyholes could use some work. Do you know how doors work?

>i
You are carrying:
  the fourth key
  the third key
  the second key

>put second key in second keyhole
You put the second key into second keyhole.

>use tentacles to unlock final door
I do believe those keyholes could use some work. Do you know how doors work?

>put third key in third keyhole
You put the third key into third keyhole.

>use tentacles to unlock final door
I do believe those keyholes could use some work. Do you know how doors work?

>put fourth key in fourth keyhole
You put the fourth key into fourth keyhole.

>use tentacles to unlock final door
You reach out with your tentacles, and grasp the four keys and four doorknobs. All at once, you turn them to the right. The great doors ease open with a slight creek as the world around you fades into a white nothingness, and you stand alone in a smooth plane. You against me.

I'll release you for now. If you bring me a present next year I might consider turning you back into a human.

    *** The End ***

Would you like to RESTART, RESTORE a saved game, QUIT or UNDO the last command?

* * *

>search couch
You search throughout the couch lazily and find only crumbs. You could scoop them up I guess?

Though you've never been the best finder-of-things, particularly due to your atrocious eyesight and generally dreadful searching ability, you think the couch has the crumbs.

>take key
Taken.

* * *

>x fish tank
In the fish tank is the fourth key.

>open fish tank
It isn't something you can open.

>close fish tank
It isn't something you can close.

>take fouth key
You can't see any such thing.

>take key
(the fourth key)
The fish tank isn't open.

>open fish tank
It isn't something you can open.

>open tank
It isn't something you can open.

* * *

>unlock door with key
You unlock the first door.

>e
Great Room
A grand room built from giant blocks of a sand-colored stone, stacked up to a ceiling high above where a massive compass lays embedded in the rock.

Behind you to the west you see a hallway, hewn out of the stone, leading  to another room.

Before you to the east, taking up almost the entire wall, is a great metal door painted a deep blue and patterned with yellow and white veins that run throughout. At the base of the door are four keyholes and four doorknobs.

>w
Cluttered Room
A room, half the size of the previous room, filled to the brim with chairs, folded tables, closed crates, and smaller tidbits scattered about.

Behind you to the east you see a hallway, hewn out of the stone, leading  to another room.

To the south, almost obscured behind a large gray couch, you see a door.

To your right you see a dented bucket overflowing with junk. Or maybe it's important items for progressing in the game.

The couch, lying to your left in front of the door, sags with (fake) age, and it's got tears in the tattered fabric in some places.

>s
(first opening the first door)

Cobble Wall
You push through the door, and find yourself in a tiny room. To your left a cobblestone wall stretches up high above, ending just before the ceiling. Rocks here and there seem to have fallen out of the wall over the ages it has stood in place, creating holes of varying sizes throughout the surface.

To the north you can see the door you came through earlier.

In the center of the wall to the east, you can see a hole as average as yourself. It's so normal it's disappointing.

To the southeast, you can see a miniscule hole, barely larger than your average United State dime, a ten-cent coin, one tenth of a United States dollar, labeled formally as "one dime". The denomination was first authorized by the Coinage Act of 1792. The dime is the smallest in diameter and is the thinnest of all U.S. coins currently minted for circulation, being 0.705 inches (17.91 millimeters) in diameter and 0.053 in (1.35 mm) in thickness. The hole is that size.

To the northeast, you see a hole roughly the size of a fist, punched through the rock in a feat of strength, possibly in frustration, possibly with this game.

* * *

>set lock to 549.56
The dial clicks as you set the number.

>set lock to 56.54
The dial clicks as you set the number.

>set lock to 569.54
The dial clicks as you set the number.

>s
Library (Shelf #1)
This section of the library is much the same as all the rest: shelves of books to either side, untouched books lying on their shelves. The main room is back to the north, and the shelves continue south.

Lying on the shelf to your left, a dustless green tome lies on its side. Gold lettering on its spine reads "The Dialogues of Plato." Lower down, its call number is printed: 184.2.

Standing on the right shelf, a tome with a suspicious amount of dust rests on the right shelf. Silver lettering on its spine reads "The Great Transformation," and below that its call number is written "200.9."

>s
Library (Shelf #2)
This section of the library is much the same as all the rest: shelves of books to either side, untouched books lying on their shelves. The library continues both north and south.

Directly in front of you, a white novel rests on the ground. Black type on its cover reads "Outliers." On its spine a call number is printed: 302.6.

A yellow book peeks over the edge of the right shelf. From where you stand, you can see bold black-and-blue lettering, "Because Internet." On its spine, a call number reads "402.231."

>s
Library (Shelf #3)
This section of the library is much the same as all the rest: shelves of books to either side, untouched books lying on their shelves. A small glyph is carved into the wood of a shelf here that looks faintly like an "x," but you can't quite recognize what it is. The library continues both north and south.

On one of the shelves here, a dustless book rests facing you. On its cover, a detailed picture of a pie is partly obscured by the text, "Eight Pies," emblazoned in white. On its spine a call number is printed: 594.56.

Right next to the recipe book, a black book seems to have disturbed the dust. On its cover, yellow ASCII marks the book as "Cult of the Dead Cow." On its spine, a call number reads "605.8."

>n
Library (Shelf #2)
This section of the library is much the same as all the rest: shelves of books to either side, untouched books lying on their shelves. The library continues both north and south.

Directly in front of you, a white novel rests on the ground. Black type on its cover reads "Outliers." On its spine a call number is printed: 302.6.

A yellow book peeks over the edge of the right shelf. From where you stand, you can see bold black-and-blue lettering, "Because Internet." On its spine, a call number reads "402.231."

>n
Library (Shelf #1)
This section of the library is much the same as all the rest: shelves of books to either side, untouched books lying on their shelves. The main room is back to the north, and the shelves continue south.

Lying on the shelf to your left, a dustless green tome lies on its side. Gold lettering on its spine reads "The Dialogues of Plato." Lower down, its call number is printed: 184.2.

Standing on the right shelf, a tome with a suspicious amount of dust rests on the right shelf. Silver lettering on its spine reads "The Great Transformation," and below that its call number is written "200.9."

>n
Library
A great library, full to the brim with books. The shelves continue further south.

Behind you to the west, you see a rocky door in the wall.

To the east you see a thick metal door, its industrial design a strange contrast to the otherwise ancient architecture you've encountered in this world so far.

Extruded from the door is a safe labeled "KEY", held closed by a 5-digit combination lock. There's a decimal point between the third and fourth digit of the number, which is odd for a combination lock.

>set lock to 594.56
The safe lid pops open with a rush of air as the seal is broken. Inside, you see the third key.

* * *

>i
You are carrying:
  the third key
  the second key
  the angry fish
  some crumbs
  a first key

>put fish in tank
(the angry fish in the fish tank)
Failure.

>i
You are carrying:
  the third key
  the second key
  the angry fish
  some crumbs
  a first key

>feed fish the crumbs
(the angry fish the crumbs)
The fish, though hesitant at first, wolfs down the crumbs in a matter of seconds and wiggles happily. I'm sure it would be inclined to help you out if you ever needed anything fish-related.

>put fish in tank
(the happy fish in the fish tank)
Success!

You put the happy fish into the fish tank.

>x tank
A large glash fishtank that takes up most of the space in the room, and seems to be around two and a half meters tall. Half submerged in the sand at the bottom of the fish tank, a small metal object glints and sparkles in the light. A sign next to the tanks says in red, "NO MOLLUSCS IN THE TANK."

In the fish tank is the happy fish.

* * *

>search couch
You search throughout the couch lazily and find only crumbs. You could scoop them up I guess?

>take key
You can't see any such thing.

>unlock door with key
You can't see any such thing.

>s
(first opening the first door)
It seems to be locked.

>se
You can't go that way.

>take key
You can't see any such thing.

>nw
You can't go that way.

>unlock center hole with second key
You insert the key you found into the hole in the wall, and hear a slight click. You turn the key to the left like a total dimwit, but correct yourself before the key snaps and twist the other direction. A small section of the wall eases forward with a sigh, revealing a passageway east.

>s
You can't go that way.

>e
You push open the rocky door and move onwards through a short passageway.

Library
You arrive in a long room full of thousands and thousands of bookshelves, full to the brim with dust-covered tomes. An ancient library, with books on topics much to complex for you to understand. The shelves continue further south.

Behind you to the west, you see a rocky door in the wall.

To the east you see a thick metal door, its industrial design a strange contrast to the otherwise ancient design you've encountered in this world so far. Extruded from the door is a box labeled "KEY", apparently held closed by a 2-digit combination lock, which is a little odd for state-of-the-art security.

* * *

>s
Library (Shelf #2)
This section of the library is much the same as all the rest: shelves of books to either side, untouched books lying on their shelves.

Directly in front of you, a white novel rests on the ground. Black type on its cover reads "Outliers." On its spine a call number is printed: 302.6.

Peeking over the edge of the right shelf, a yellow book hangs above your head face-down. From where you stand, you can see bold black-and-blue lettering, "Because Internet." On its spine, a call number reads "402.231."

>x because internet
/-\|_|_ /-\|30|_|"][" "]["|-|3 1|\/||D/-\("]["5 0|= "]["|-|3 \^/0|2|_|) \^/1|)3 \^/3|3 0|\| |\/|0|)3|2|\| 3|\|6|_15|-| |_1|\|6|_|15"]["1(5. |=|20|\/| (0|\/||\/||_||\|1"]["`/ 5|D3(1|=1( _|/-\|260|\|, "]["0 63|\|3|2/-\|_ (0|\/||\/|3|\|"][" 5"]["|2|_|("]["|_||235, "]["0 |_/-\|\|6|_|/-\635 |_1|<3 |_33"][" 5|D3/-\|<, "]["|-|3 1|\|"]["3|2|\|3"][" |-|/-\5 |D|20|=0|_||\||)|_`/ 5|-|/-\|D3|) |-|0\^/ \^/3 (0|\/||\/||_||\|1(/-\"]["3 - (|-|/-\|\|61|\|6 |=|20|\/| |D|_/-\"]["|=0|2|\/| "]["0 |D|_/-\"]["|=0|2|\/|, |200|\/| "]["0 |\|3><"][" |200|\/|.

Title: Because Internet: Understanding the New Rules of Language
Call number: 402.231

* * *

>nw
You can't go that way.

>unlock door with second key
You can't see any such thing.

>insert second key into the center hole
You can't see any such thing.

>e
Great Room
A grand room built from giant blocks of a sand-colored stone, stacked up to a ceiling high above where a massive compass lays embedded in the rock.

Behind you to the west you see a hallway, hewn out of the stone, leading  to another room.

Before you to the east, taking up almost the entire wall, is a great metal door painted a deep blue and patterned with yellow and white veins that run throughout. At the base of the door are four keyholes and four doorknobs.

>set lock to 594.56
You can't see any such thing.

>take third key
You can't see any such thing.

>unlock door with third key
You can't see any such thing.

>e
(first opening Final Door)
It seems to be locked.

>x tank
You can't see any such thing.

* * *

>search couch
You search throughout the couch lazily and find only crumbs. You could scoop them up I guess?

>take key
Taken.

>unlock door
(with the first key)
You unlock the first door.

>s
(first opening the first door)

Cobble Wall
You push through the door, and find yourself in a thin, wide room that ends abruptly in front you in an ancient cobblestone wall. The wall stretches up high above, ending just before the ceiling. Rocks here and there seem to have fallen out of the wall over the ages it has stood in place, creating holes of varying sizes in the walls (though as I believe I've made clear, it's not actually ancient because it's fake so the holes have been there since I created it).

To the north you can see the door you came through earlier.

Directly in front of you - to the east, imbicile - you see a hole as average as yourself. It's so normal it's dissapointing.

To the southeast, you can see a miniscule hole, barely larger than your average United State dime, a ten-cent coin, one tenth of a United States dollar, labeled formally as "one dime". The denomination was first authorized by the Coinage Act of 1792. The dime is the smallest in diameter and is the thinnest of all U.S. coins currently minted for circulation, being 0.705 inches (17.91 millimeters) in diameter and 0.053 in (1.35 mm) in thickness. The hole looks like that.

In the northeast of the wall, you see a hole roughly the size of a fist, punched through the rock in a feat of strength far out of reach of one such as yourself.

>se
Teensy Cave of Fortune
In the dust below your feet, a small silver key glints in the dim light.

Behind you to the northwest, light streams in from the tiny entrance.

You can also see the second key here.

* * *

>set code to 594.56
You can't see any such thing.

>set lock to 594.56
The safe lid pops open with a rush of air as the seal is broken. Inside, you see the third key.

* * *

>x tank
In the fish tank is the fourth key.

>take key
(the fourth key)
Taken.

>kiss ass
You can't see any such thing.

>kiss self
You don't get much from that.

>look at self
As good-looking as ever.

* * *

>s
You can't go that way.

>e
You push open the rocky door and move onwards through a short passageway.

Library
You arrive in a long room full of thousands and thousands of bookshelves, full to the brim with dust-covered tomes. An ancient library, with books on topics much to complex for you to understand. The shelves continue further south.

Behind you to the west, you see a rocky door in the wall.

To the east you see a thick metal door, its industrial design a strange contrast to the otherwise ancient design you've encountered in this world so far.

* * *

>take crumbs
Taken.

>take crumbs
You already have those.

>search couch
You look through the couch, and find nothing. I made the couch bigger on the inside than the outside, so it's extra hard to find anything hiding inside.

* * *

>take key
Taken.

>take key
You already have that.

>search couch
I'm just going to say it: there's nothing else in the couch. (Though I might say that if there really was something else in the couch. But there isn't. Unless...)

>open door with key
You unlock the first door.

>look
Cluttered Room
A room, half the size of the previous room, filled to the brim with chairs, folded tables, closed crates, and smaller tidbits scattered about.

Back to the east you see a hallway, hewn out of the stone, leading to another room.

To the south, almost obscured behind a large gray couch, you see a closed door.

To your left you see a dented bucket overflowing with junk. Or maybe it's important items for progressing in the game.

The couch lying in front of the door sags with (fake) age, and it's got tears in the tattered fabric in some places.

>s
(first opening the first door)

Cobble Wall
You push through the door, and find yourself in a thin, wide room that ends abruptly in front you in an ancient cobblestone wall.

To the south, almost obscured behind a large gray couch, you see a closed door.

The wall stretches up high above, ending just before the ceiling. Rocks here and there seem to have fallen out of the wall over the ages it has stood in place, creating fist-sized holes in the walls (though as I believe I've made clear, it's not actually ancient because it's fake so the holes have been there since I created it).

* * *

>search couch
You search throughout the couch lazily and find only crumbs. You could scoop them up I guess?

>take crumbs and key and fish
crumbs: Taken.
first key: Taken.
angry fish: Taken.

>feed crumbs to fish
You can't see any such thing.

>feed fish the crumbs
The fish, though hesitant at first, wolfs down the crumbs in a matter of seconds and wiggles happily. I'm sure it would be inclined to help you out if you ever needed anything fish-related.

>unlock door with key
You unlock the first door.

>e
Great Room
A grand room built from giant blocks of a sand-colored stone, stacked up to a ceiling high above where a massive compass lays embedded in the rock.

Behind you to the west you see a hallway, hewn out of the stone, leading  to another room.

To the south, a small blue door is embedded in the rock. In the Middle Eastern style, the top of the door is a semicircle.

Before you to the east, taking up almost the entire wall, is a great metal door painted a deep blue and patterned with yellow and white veins that run throughout. At the base of the door are four keyholes and four doorknobs.

>s
(first opening the small blue door)
It seems to be locked.

>w
Cluttered Room
A room, half the size of the previous room, filled to the brim with chairs, folded tables, closed crates, and smaller tidbits scattered about.

Behind you to the east you see a hallway, hewn out of the stone, leading  to another room.

To the south, almost obscured behind a large gray couch, you see a door.

To your right you see a dented bucket overflowing with junk. Or maybe it's important items for progressing in the game.

The couch, lying to your left in front of the door, sags with (fake) age, and it's got tears in the tattered fabric in some places.

* * *

>set lock to 549,56
The dial clicks as you set the number.

That's not a verb I recognise.

>set lock to 549.56
The dial clicks as you set the number.

>set lock to 594.56
The safe lid pops open with a rush of air as the seal is broken. Inside, you see the third key.

* * *

>put fish in tank
(the happy fish in the fish tank)
You reach above the glass lip with a tentacle and drop the fish into the water. It gives you a little wink and dives to the bottom of the tank, disappearing into the reef. A few seconds later a small silver key flies out of the water and hit you square between the eyes, falling to the floor.

>take fourth key
Taken.

>unlock blue door with fourth key
You unlock the small blue door.

>n
(first opening the small blue door)

Great Room
A grand room built from giant blocks of a sand-colored stone, stacked up to a ceiling high above where a massive compass lays embedded in the rock.

To the south, a small blue door is embedded in the rock. In the Middle Eastern style, the top of the door is a semicircle.

Behind you to the west you see a hallway, hewn out of the stone, leading  to another room.

Before you to the east, taking up almost the entire wall, is a great metal door painted a deep blue and patterned with yellow and white veins that run throughout. At the base of the door are four keyholes and four doorknobs.

>unlock great door
What do you want to unlock Final Door with?

>unlock great door with keys
Which do you mean, the fourth key, the third key, the second key or the first key?

>unlock great door with the first key
You reach out with your tentacles, and grasp the four keys and four doorknobs. All at once, you turn them to the right. The great doors ease open with a slight creek as the world around you fades into a white nothingness, and you stand alone in a smooth plane. You against me.

I'll release you for now. If you bring me a present next year I might consider turning you back into a human.

    *** The End ***

Would you like to RESTART, RESTORE a saved game, QUIT or UNDO the last command?

* * *

>ne
You squeeze yourself through the hole with surprising ease, but due to your inability to do anything properly you cause the entrance to cave in behind you. You find yourself in a bare cave, no larger than a fist, with no way to escape your tiny prison. Anyways, I'm not sticking around to watch you starve.

    *** The End ***

Would you like to RESTART, RESTORE a saved game, QUIT or UNDO the last command?

>undo
Cobble Wall
[Previous turn undone.]

>se
Teensy Cave of Fortune
Behind you to the northwest, light streams in from the puny cave's entrance.

In the dust below your feet, a small silver key glints in the dim light.

* * *

>take key
(the second key)
Taken.

>nw
Cobble Wall
A tiny room that ends abruptly to your left in an ancient cobblestone wall. The wall stretches up high above, ending just before the ceiling. Rocks here and there seem to have fallen out of the wall over the ages it has stood in place, creating holes of varying sizes in the walls (though as I believe I've made clear, it's not actually ancient because it's fake so the holes have been there since I created it).

To the southeast, you can see a miniscule hole, barely larger than your average United State dime, a ten-cent coin, one tenth of a United States dollar, labeled formally as "one dime". The denomination was first authorized by the Coinage Act of 1792. The dime is the smallest in diameter and is the thinnest of all U.S. coins currently minted for circulation, being 0.705 inches (17.91 millimeters) in diameter and 0.053 in (1.35 mm) in thickness. The hole looks like that.

To the north you can see the door you came through earlier.

In the center of the wall you can see a hole as average as yourself. It's so normal it's dissapointing.

In the northeast of the wall, you see a hole roughly the size of a fist, punched through the rock in a feat of strength far out of reach of one such as yourself.

>unlock center hole with second key
You insert the key you found into the hole in the wall, and hear a slight click. You turn the key to the left like a total dimwit, but correct yourself before the key snaps and twist the other direction. A small section of the wall eases forward with a sigh, revealing a passageway east.

>e
You push open the rocky door and move onwards through a short passageway.

Library
You arrive in a long room full of thousands and thousands of bookshelves, full to the brim with dust-covered tomes. An ancient library, with books on topics much to complex for you to understand. The shelves continue further south.

In the center of the wall you can see a hole as average as yourself. It's so normal it's dissapointing.

To the east you see a thick metal door, its industrial design a strange contrast to the otherwise ancient design you've encountered in this world so far.

* * *

>insert second key in center hole
You insert the key you found into the hole in the wall, and hear a slight click. You turn the key to the left like a total dimwit, but correct yourself before the key snaps and twist the other direction. A small section of the wall eases forward with a sigh, revealing a passageway east.

>e
You push open the rocky door and move onwards through a short passageway.

Library
You arrive in a long room full of thousands and thousands of bookshelves, filled to the brim with dust-covered tomes. An ancient library, with books on topics much too complex for you to understand. The shelves continue further south.

Behind you to the west, you see a rocky door in the wall.

To the east you see a thick metal door, its industrial design a strange contrast to the otherwise ancient architecture you've encountered in this world so far.

Extruded from the door is a safe labeled "KEY", held closed by a 5-digit combination lock. There's a decimal point between the third and fourth digit of the number, which is odd for a combination lock.

>set lock to 546.59
The dial clicks as you set the number.

>set lock 596.54
I didn't understand that sentence.

>set lock to 596.54
The dial clicks as you set the number.

>s
Library (Shelf #1)
This section of the library is much the same as all the rest: shelves of books to either side, untouched books lying on their shelves. The main room is back to the north, and the shelves continue south.

Lying on the shelf to your left, a dustless green tome lies on its side. Gold lettering on its spine reads "The Dialogues of Plato." Lower down, its call number is printed: 184.2.

Standing on the right shelf, a tome with a suspicious amount of dust rests on the right shelf. Silver lettering on its spine reads "The Great Transformation," and below that its call number is written "200.9."

* * *

>n / n / n
I only understood you as far as wanting to (go) n.

>n
Library (Shelf #2)
This section of the library is much the same as all the rest: shelves of books to either side, untouched books lying on their shelves. The library continues both north and south.

Directly in front of you, a white novel rests on the ground. Black type on its cover reads "Outliers." On its spine a call number is printed: 302.6.

A yellow book peeks over the edge of the right shelf. From where you stand, you can see bold black-and-blue lettering, "Because Internet." On its spine, a call number reads "402.231."

* * *

>set lock to 594.56
The safe lid pops open with a rush of air as the seal is broken. Inside, you see the third key.

>take third key
Taken.

* * *

>unlock door with third key
You unlock the third door.

>look
Library
A great library, full to the brim with books. The shelves continue further south.

Behind you to the west, you see a rocky door in the wall.

To the east you see a thick metal door, its industrial design a strange contrast to the otherwise ancient architecture you've encountered in this world so far.

Extruded from the door is a safe labeled "KEY", held closed by a 5-digit combination lock. There's a decimal point between the third and fourth digit of the number, which is odd for a combination lock.

>e
(first opening the third door)

Aquarium
You push through the door, and find yourself in a drastically different room with plain concrete walls and a black floor flecked with gray spots. The ceiling looks basically the same as the walls from where you're standing, but between you and me, it's a "living roof" - a roof with a grass on top.

To the west you see a thick metal door.

In the center of the room, taking up the majority of the space in the room is a giant fishtank. The first half meter of the tank is an black wall, presumably hiding the inner workings of the tank. Above the base, the glass tank walls extend up for two meters, where they end at a mesh lid.

>x aquarium
A large

In the fish tank is the fourth key.

>look
Aquarium
A large room with plain concrete walls and a black floor flecked with gray spots. The ceiling looks basically the same as the walls from where you're standing, but between you and me, it's a "living roof" - a roof with a grass on top.

To the west you see a thick metal door.

In the center of the room, taking up the majority of the space in the room is a giant fishtank. The first half meter of the tank is an black wall, presumably hiding the inner workings of the tank. Above the base, the glass tank walls extend up for two meters, where they end at a mesh lid.

* * *

>s
Library (Shelf #1)
This section of the library is much the same as all the rest: shelves of books to either side, untouched books lying on their shelves.

Lying on the shelf to your left, a dustless green tome lies on its side. Gold lettering on its spine reads "The Dialogues of Plato." Lower down, its call number is printed: 184.2.

Standing on the right shelf, a tome with a suspicious amount of dust rests on the right shelf. Silver lettering on its spine reads "The Great Transformation," and below that its call number is written "200.9."

>x dialogues
You don't know much about this book because you're an fool, but luckily it comes with a description on the back.

"Socrates' ancient words are still true, and the ideas found in Plato's Dialogues still form the foundation of a thinking person's education. This superb collection contains excellent contemporary translations selected for their clarity and accessibility to today's reader, as well as an incisive introduction by Erich Segal, which reveals Plato's life and clarifies the philosophical issues examined in each dialogue. The first four dialogues recount the trial and execution of Socrates-the extraordinary tragedy that changed Plato's life and forever altered the course of Western thought. Other dialogues create a rich tableau of intellectual life in Athens in the fourth century b.c., and examine such timeless-and timely-issues as the nature of virtue and love, knowledge and truth, society and the individual. Resounding with the humor and astounding brilliance of Socrates, the immortal iconoclast, these great works remain powerful, probing, and essential."

Title - The Dialogues of Plato
Call number - 184.2

>x transformation
An analysis of the peoples and religions of four distinct regions (China, India, Israel, and Greece) in the ninth century BCE, written by Karen Armstrong. Currently has 3,467 ratings at an average of 4.03 stars on Goodreads.

Title - The Great Transformation
Call number - 200.9

>take transformation
Taken.

>take dialogues
Taken.

>l
Library (Shelf #1)
This section of the library is much the same as all the rest: shelves of books to either side, untouched books lying on their shelves.

>s
Library (Shelf #2)
This section of the library is much the same as all the rest: shelves of books to either side, untouched books lying on their shelves.

Directly in front of you, a white novel rests on the ground. Black type on its cover reads "Outliers." On its spine a call number is printed: 302.6.

Peeking over the edge of the right shelf, a yellow book hangs above your head face-down. From where you stand, you can see bold black-and-blue lettering, "Because Internet." On its spine, a call number reads "402.231."

>x outliers
A pretty good book by Malcolm Gladwell, about the most famous and successful people in the world. He also draws an interesting conclusion that focuses more on their upbringing, culture, and family than personality attributes and habits - considering your utter lack of culture, I would say it's a safe bet that you're in the middle of this Gaussian curve.

Title - Outliers: The Story of Success
Call number - 302.6

>x internet
4ll 4b0u7 7h3 1mp4c75 0f 7h3 w0rld w1d3 w3b 0n m0d3rn 3n6l15h l1n6u1571c5. fr0m c0mmun17y 5p3c1f1c j4r60n, 70 63n3r4l c0mm3n7 57ruc7ur35, 70 l4n6u4635 l1k3 l337 5p34k, 7h3 1n73rn37 h45 pr0f0undly 5h4p3d h0w w3 c0mmun1c473 - ch4n61n6 fr0m pl47f0rm 70 pl47f0rm, r00m 70 n3x7 r00m.

Title - Because Internet: Understanding the New Rules of Language
Call number - 402.231

>take outliers and internet
Outliers: Taken.
Because Internet: Taken.

>l
Library (Shelf #2)
This section of the library is much the same as all the rest: shelves of books to either side, untouched books lying on their shelves.

>s
Library (Shelf #3)
This section of the library is much the same as all the rest: shelves of books to either side, untouched books lying on their shelves.

On one of the shelves here, a dustless book rests facing you. On its cover, a detailed picture of a pie is partly obscured by the text, "Eight Pies," emblazoned in white. On its spine a call number is printed: 594.56.

Right next to the recipe book, a black book seems to have disturbed the dust. On its cover, yellow ASCII marks the book as "Cult of the Dead Cow." On its spine, a call number reads "605.8."

>x pies
A really fantastic book about the delicious art of making eight kinds of pie, written by Greek author Krymmnos Syndyasms.

Title - Eight Pies
Call number - 594.56

>x cult of the dead cow
An incredible classic written about the original group of elite hackers, and how they changed the landscape of computing forever. You should read it.

Title - Cult of the Dead Cow: How the Original Hacking Supergroup Might Just Save the World
Call number - 605.8

>take pies and cow
Eight Pies: Taken.
Cult of the Dead Cow: Taken.

>s
Library (Shelf #4)
This section of the library is much the same as all the rest: shelves of books to either side, untouched books lying on their shelves. A small glyph is carved into the wood of a shelf here that looks faintly like an "x," but you can't quite recognize what it is.

In a small gap in the books, a blue book leans across: "Born a Crime." On its spine a call number is printed: 791.4502.

A white and red book lies flat on top of the other books here. Written in black about a great red pirate flag are the words, "Enemy of All Mankind." On its spine, a call number reads "910.45."

>s
You can't go that way.

>x crime and mankind
You can't use multiple objects with that verb.

>x crime
Trevor Noah, now host of the Daily Show, writes about his childhood as a mixed child in apartheid South Africa.

Title - Born a Crime: Stories From A South African Childhood
Call number - 791.4502.

>x mankind
I don't really know much about this book, but it's about pirates and I thought that was cool.

Title - Enemy of All Mankind: A True Story of Piracy, Power, and History's First Global Manhunt
Call number - 910.45

>take crime and mankind
Born a Crime: You're carrying too many things already.
Enemy of All Mankind: You're carrying too many things already.

>i
You are carrying:
  Cult of the Dead Cow
  Eight Pies
  Because Internet
  Outliers
  The Dialogues of Plato
  The Great Transformation
  the second key
  a first key

>n
Library (Shelf #3)
This section of the library is much the same as all the rest: shelves of books to either side, untouched books lying on their shelves.

>n
Library (Shelf #2)
This section of the library is much the same as all the rest: shelves of books to either side, untouched books lying on their shelves.

>n
Library (Shelf #1)
This section of the library is much the same as all the rest: shelves of books to either side, untouched books lying on their shelves.

>n
Library
A great library, full to the brim with books. The shelves continue further south.

Behind you to the west, you see a rocky door in the wall.

To the east you see a thick metal door, its industrial design a strange contrast to the otherwise ancient design you've encountered in this world so far. Extruded from the door is a box labeled "KEY", apparently held closed by a 2-digit combination lock, which is a little odd for state-of-the-art security.

* * *

>unlock door with third key
You unlock the third door.

>e
(first opening the third door)

Aquarium
You push through the door, and find yourself in a drastically different room with plain concrete walls and a black floor flecked with gray spots. The ceiling looks basically the same as the walls from where you're standing, but between you and me, it's a "living roof" - a roof with a grass on top.

To the west you see a thick metal door.

In the center of the room, taking up the majority of the space in the room is a giant fishtank. The first half meter of the tank is an black wall, presumably hiding the inner workings of the tank. Above the base, the glass tank walls extend up for two meters, where they end at a mesh lid.

>x aquarium
A large fishtank that takes up most of the space in the room. Seems to be around two and a half meters tall, and capped with a mesh lid.

>open aquarium
It isn't something you can open.

>open fish tank
It isn't something you can open.

* * *

>s
Library (Shelf #1)
This section of the library is much the same as all the rest: shelves of books to either side, untouched books lying on their shelves. Two books seem to stand out, less dusty than the rest.

Lying on the shelf to your left, a dustless green tome lies on its side. Gold lettering on its spine reads "THE DIALOGUES OF PLATO." Lower down, its call number is printed: 184.26.

Standing on the right shelf, a tome with a suspicious amount of dust rests on the right shelf. Silver lettering on its spine reads "THE GREAT TRANSFORMATION," and below that its call number is written "200.9."

>x the dialogues of plato
You don't know much about this book because you're an fool, but luckily it comes with a description on the back.

"Socrates" ancient words are still true, and the ideas found in Plato's Dialogues still form the foundation of a thinking person's education. This superb collection contains excellent contemporary translations selected for their clarity and accessibility to today's reader, as well as an incisive introduction by Erich Segal, which reveals Plato's life and clarifies the philosophical issues examined in each dialogue. The first four dialogues recount the trial and execution of Socrates-the extraordinary tragedy that changed Plato's life and forever altered the course of Western thought. Other dialogues create a rich tableau of intellectual life in Athens in the fourth century b.c., and examine such timeless-and timely-issues as the nature of virtue and love, knowledge and truth, society and the individual. Resounding with the humor and astounding brilliance of Socrates, the immortal iconoclast, these great works remain powerful, probing, and essential."

>x the great transformation
An analysis of the peoples and religions of four distinct regions in the ninth century BCE, written by Karen Armstrong. Currently has 3,467 ratings at an average of 4.03 stars on Goodreads.

>take the dialogues of plato
Taken.

>take the great transformation
Taken.

>i
You are carrying:
  The Great Transformation
  The Dialogues of Plato
  the second key
  a first key

* * *

>search couch
You search throughout the couch lazily and find only crumbs. You could scoop them up I guess?

>w
You can't go that way.

>w
You can't go that way.

>search couch
You search under the couch and under the cushions, and find a small key hiding underneath.

* * *

>search couch
You search throughout the couch lazily and find only crumbs.
You could scoop them up I guess?

>scoop up crumbs
Taken.

* * *

>search couch
You search under the couch and under the cushions, and find a mountain of crumbs and a small key hiding underneath.

>take crumbs
Taken.

>eat crumbs
You eat them, and are forever lowered in my eyes you disgusted being. You should be ashamed, for what you have done right now is irredeemable.

>search couch
You began searching with low expectations, but you still found a way to dissapoint.

Though you've never been the best finder-of-things, particularly due to your atrocious eyesight and generally dreadful searching ability, you think the couch has nothing.

>i
You are carrying:
  some crumbs

* * *

>search couch
You began searching with low expectations, but you still found a way to dissapoint.

Though you've never been the best finder-of-things, particularly due to your atrocious eyesight and generally dreadful searching ability, you think the couch has nothing.

>search couch
You search under the couch and under the cushions, and find a small key hiding underneath.

* * *

>look
Cluttered Room
A room, half the size of the previous room, filled to the brim with chairs, folded tables, closed crates, and smaller tidbits scattered about.

Behind you to the east you see a hallway, hewn out of the stone, leading  to another room.

To the south, almost obscured behind a large gray couch, you see a door.

To your right you see a dented bucket overflowing with junk. Or maybe it's important items for progressing in the game.

The couch, lying to your left in front of the door, sags with (fake) age, and it's got tears in the tattered fabric in some places.

>unlock door with key
You unlock the first door.

>s
(first opening the first door)

Cobble Wall
You push through the door, and find yourself in a tiny room that ends abruptly to your left in an ancient cobblestone wall. The wall stretches up high above, ending just before the ceiling. Rocks here and there seem to have fallen out of the wall over the ages it has stood in place, creating holes of varying sizes in the walls (though as I believe I've made clear, it's not actually ancient because it's fake so the holes have been there since I created it).

To the north you can see the door you came through earlier.

In the center of the wall you can see a hole as average as yourself. It's so normal it's dissapointing.

To the southeast, you can see a miniscule hole, barely larger than your average United State dime, a ten-cent coin, one tenth of a United States dollar, labeled formally as "one dime". The denomination was first authorized by the Coinage Act of 1792. The dime is the smallest in diameter and is the thinnest of all U.S. coins currently minted for circulation, being 0.705 inches (17.91 millimeters) in diameter and 0.053 in (1.35 mm) in thickness. The hole looks like that.

In the northeast of the wall, you see a hole roughly the size of a fist, punched through the rock in a feat of strength far out of reach of one such as yourself.

>ne
You squeeze yourself through the hole with surprising ease, but due to your inability to do anything properly you cause the entrance to cave in behind you. You find yourself in a bare cave, no larger than a fist, with no way to escape your tiny prison. Anyways, I'm not sticking around to watch you starve.

    *** The End ***

Would you like to RESTART, RESTORE a saved game, QUIT or UNDO the last command?

* * *

>unlock center hole
What do you want to unlock the center hole with?

>unlock center hole with keyh
You can't see any such thing.

>unlock center hole with key
Which do you mean, the second key or the first key?

>unlock center hole with second key
You insert the key you found into the hole in the wall, and hear a slight click. You turn the key to the left like a total dimwit, but correct yourself before the key snaps and twist the other direction. A small section of the wall eases forward with a sigh, revealing a passageway east.

>e
You push open the rocky door and move onwards through a short passageway.

Library
Frustrated, you arrive in a room full of thousands and thousands of books. Just as the thought crosses your mind, you hear that voice again.

"It's not a room full of books, you imbecile. It's a library."

That would make sense. To the east you see a hallway continuing into the next room.

On the wall is a giant sign that says "PUZZLE INOPERABLE."

In the center of the wall you can see a hole as average as yourself. It's so normal it's dissapointing.

I beg your pardon?

* * *

>take key
Taken.

>look
Cluttered Room
A room, half the size of the previous room, filled to the brim with chairs, folded tables, closed crates, and smaller tidbits scattered about.

Back to the east you see a hallway, hewn out of the stone, leading to another room.

To the south, almost obscured behind a large gray couch, you see a door.

To your left you see a dented bucket overflowing with junk. Or maybe it's important items for progressing in the game.

The couch lying in front of the door sags with (fake) age, and it's got tears in the tattered fabric in some places.

>unlock door with key
You unlock the first door.

>go s
(first opening the first door)

Cobble Wall
You push through the door, and find yourself in a thin, wide room that ends abruptly in front you in an ancient cobblestone wall. The wall stretches up high above, ending just before the ceiling. Rocks here and there seem to have fallen out of the wall over the ages it has stood in place, creating holes of varying sizes in the walls (though as I believe I've made clear, it's not actually ancient because it's fake so the holes have been there since I created it).

To the north you can see the door you came through earlier.

Directly in front of you you see a hole as average as yourself. It's so normal it's dissapointing.

To your right you see a miniscule hole, barely larger than your average United State dime, a ten-cent coin, one tenth of a United States dollar, labeled formally as "one dime". The denomination was first authorized by the Coinage Act of 1792. The dime is the smallest in diameter and is the thinnest of all U.S. coins currently minted for circulation, being 0.705 inches (17.91 millimeters) in diameter and 0.053 in (1.35 mm) in thickness. The hole looks like that.

To your left you see a hole roughly the size of a fist, punched through the rock in a feat of strength far out of reach of one such as yourself.

>go through hole on the left
You can't see any such thing.

* * *

>search couch
You search under the couch and under the cushions, and find a mountain of crumbs and a small key hiding underneath.

>take crumbs and key and fish
crumbs: Taken.
silver key: Taken.
angry fish: Taken.

>unlock door with first key
I only understood you as far as wanting to unlock the first door with the first door.

>e
Great Room
A grand room built from giant blocks of a sand-colored stone, stacked up to a ceiling high above where a massive compass lays embedded in the rock.

Behind you to the west you see a hallway, hewn out of the stone, leading  to another room.

To the south, a small blue door is embedded in the rock.

Before you to the east, taking up almost the entire wall, is a great metal door painted a deep blue and patterned with yellow and white veins that run throughout. At the base of the door are four keyholes and four doorknobs.

>w
Cluttered Room
A room, half the size of the previous room, filled to the brim with chairs, folded tables, closed crates, and smaller tidbits scattered about.

Behind you to the east you see a hallway, hewn out of the stone, leading  to another room.

To the south, almost obscured behind a large gray couch, you see a door.

To your right you see a dented bucket overflowing with junk. Or maybe it's important items for progressing in the game.

The couch, lying to your left in front of the door, sags with (fake) age, and it's got tears in the tattered fabric in some places.

>s
(first opening the first door)
It seems to be locked.

* * *

>nw
You can't go that way.

>unlock center hole with second key
You can't see any such thing.

>e
Great Room
A grand room built from giant blocks of a sand-colored stone, stacked up to a ceiling high above where a massive compass lays embedded in the rock.

Behind you to the west you see a hallway, hewn out of the stone, leading  to another room.

To the south, a small blue door is embedded in the rock.

Before you to the east, taking up almost the entire wall, is a great metal door painted a deep blue and patterned with yellow and white veins that run throughout. At the base of the door are four keyholes and four doorknobs.

>set lock to 594.56
You can't see any such thing.

>take key
You can't see any such thing.

>unlock door with third key
Which do you mean, the small blue door, Final Door or the hidden door stuff?

>e
I didn't understand that sentence.

>feed fish the crumbs
You can't see any such thing.

>put fish in tank
You can't see any such thing.

>take ke
You can't see any such thing.

>take key
You can't see any such thing.

>unlock blue door with fourth key
You can't see any such thing.

>n
You can't go that way.

>unlock metal door with first key
You can't see any such thing.

>i
You are carrying nothing.

>look
Great Room
A grand room built from giant blocks of a sand-colored stone, stacked up to a ceiling high above where a massive compass lays embedded in the rock.

Behind you to the west you see a hallway, hewn out of the stone, leading  to another room.

To the south, a small blue door is embedded in the rock.

Before you to the east, taking up almost the entire wall, is a great metal door painted a deep blue and patterned with yellow and white veins that run throughout. At the base of the door are four keyholes and four doorknobs.

>unlock final door
What do you want to unlock Final Door with?

>unlock final door with key
You can't see any such thing.

>fourth
That's not a verb I recognise.

* * *

>take crumbs and key and fish
crumbs: Taken.
silver key: Taken.
angry fish: Taken.

>unlock door with key
You unlock the square metal door.

>s
(first opening the square metal door)

Cobble Wall
You push through the door, and find yourself in a tiny room. To your left a cobblestone wall stretches up high above, ending just before the ceiling. Rocks here and there seem to have fallen out of the wall over the ages it has stood in place, creating holes of varying sizes throughout the surface.

To the north you can see the door you came through earlier.

In the center of the wall to the east, you can see a hole as average as yourself. It's so normal it's disappointing.

To the southeast, you can see a miniscule hole, barely larger than your average United State dime, a ten-cent coin, one tenth of a United States dollar, labeled formally as "one dime". The denomination was first authorized by the Coinage Act of 1792. The dime is the smallest in diameter and is the thinnest of all U.S. coins currently minted for circulation, being 0.705 inches (17.91 millimeters) in diameter and 0.053 in (1.35 mm) in thickness. The hole is that size.

To the northeast, you see a hole roughly the size of a fist, punched through the rock in a feat of strength, possibly in frustration, possibly with this game.

>se
Teensy Cave of Fortune
Behind you to the northwest, light streams in from the puny cave's entrance.

In the dust below your feet, a small gold key glints in the dim light.

>take key
(the gold key)
Taken.

>n
You can't go that way.

>nw
Cobble Wall
A tiny room. To your left a cobblestone wall stretches up high above, ending just before the ceiling. Rocks here and there seem to have fallen out of the wall over the ages it has stood in place, creating holes of varying sizes throughout the surface.

To the southeast, you can see a miniscule hole, barely larger than your average United State dime, a ten-cent coin, one tenth of a United States dollar, labeled formally as "one dime". The denomination was first authorized by the Coinage Act of 1792. The dime is the smallest in diameter and is the thinnest of all U.S. coins currently minted for circulation, being 0.705 inches (17.91 millimeters) in diameter and 0.053 in (1.35 mm) in thickness. The hole is that size.

To the north you can see the door you came through earlier.

In the center of the wall to the east, you can see a hole as average as yourself. It's so normal it's disappointing.

To the northeast, you see a hole roughly the size of a fist, punched through the rock in a feat of strength, possibly in frustration, possibly with this game.

>x center hole
You see nothing special about the center hole.

>go center hole
You reach into the hole and try to fit through, but the hole seems to end abruptly in a cold metal surface. Feeling around more, it feels like there is some sort of hole in the metal, but you're not sure what it is. Odd.

>insert gold key to center hole
I didn't understand that sentence.

>insert gold key into center hole
You insert the key you found into the hole in the wall, and hear a slight click. You turn the key to the left like a total dimwit, but correct yourself before the key snaps and twist the other direction. A small section of the wall eases forward with a sigh, revealing a passageway east.

>e
You push open the rocky door and move onwards through a short passageway.

Library
You arrive in a long room full of thousands and thousands of bookshelves, filled to the brim with dust-covered tomes. An ancient library, with books on topics much too complex for you to understand. The shelves continue further south.

Behind you to the west, you see a rocky door in the wall.

To the east you see a thick metal door, its industrial design a strange contrast to the otherwise ancient architecture you've encountered in this world so far.

Extruded from the door is a safe labeled "KEY", held closed by a 5-digit combination lock. There's a decimal point between the third and fourth digit of the number, which is odd for a combination lock.

>enter 594.56 to safe
You try to enter the code, but it's obviously not a combination lock and thus does not do anything.

* * *

>take key
(the gold key)
Taken.

>nw
Cobble Wall
A tiny room. To your left a cobblestone wall stretches up high above, ending just before the ceiling. Rocks here and there seem to have fallen out of the wall over the ages it has stood in place, creating holes of varying sizes throughout the surface.

To the southeast, you can see a miniscule hole, barely larger than your average United State dime, a ten-cent coin, one tenth of a United States dollar, labeled formally as "one dime". The denomination was first authorized by the Coinage Act of 1792. The dime is the smallest in diameter and is the thinnest of all U.S. coins currently minted for circulation, being 0.705 inches (17.91 millimeters) in diameter and 0.053 in (1.35 mm) in thickness. The hole is that size.

To the north you can see the door you came through earlier.

In the center of the wall to the east, you can see a hole as average as yourself. It's so normal it's disappointing.

To the northeast, you see a hole roughly the size of a fist, punched through the rock in a feat of strength, possibly in frustration, possibly with this game.

* * *

>feed fish crumbs
(the angry fish the crumbs)
The fish, though hesitant at first, wolfs down the crumbs in a matter of seconds and wiggles happily. I'm sure it would be inclined to help you out if you ever needed anything fish-related.

>put fish in tank
(the happy fish in the fish tank)
Success!

You put the happy fish into the fish tank.

>x tank
A large glash fishtank that takes up most of the space in the room, and seems to be around two and a half meters tall. Half submerged in the sand at the bottom of the fish tank, a small metal object glints and sparkles in the light. The smiling fish is swimming around happily, home at last. A sign next to the tanks says in red, "NO MOLLUSCS IN THE TANK."

The smiling fish is swimming around happily, home at last.

>look
Aquarium
A large room with plain concrete walls and a black floor flecked with gray spots. The ceiling looks basically the same as the walls from where you're standing, but between you and me, it's a "living roof" - a roof with a grass on top.

To the west you see a thick metal door.

In the center of the room, taking up the majority of the space in the room is a giant fish tank. The first half meter of the tank is black glass, presumably hiding the inner workings of the tank. Above the base, the glass tank walls extend up for two meters. There does not appear to be a lid, but a sign next to the tank says in red, "NO MOLLUSCS IN THE TANK." Half submerged in the sand at the bottom of the fish tank, a small metal object glints and sparkles in the light. The smiling fish is swimming around happily, home at last.

* * *

>search couch
You search under the couch and under the cushions, and find a mountain of crumbs and a small key hiding underneath.

>take key
Taken.

>search couch
You look through the couch, and find nothing. I made the couch bigger on the inside than the outside, so it's extra hard to find anything hiding inside.

>search couch
You search throughout the couch lazily and find only crumbs.
 You could scoop them up I guess?

* * *

>take crumbs
Taken.

>search couch
I'm just going to say it: there's nothing else in the couch. (Though I might say that if there really was something else in the couch. But there isn't. Unless...)

>unlock door with key
You unlock the first door.

>s
(first opening the first door)

Cobble Wall
You push through the door, and find yourself in a thin, wide room that ends abruptly in front you in an ancient cobblestone wall.

To the north you can see the door you came through earlier.

The wall stretches up high above, ending just before the ceiling. Rocks here and there seem to have fallen out of the wall over the ages it has stood in place, creating fist-sized holes in the walls (though as I believe I've made clear, it's not actually ancient because it's fake so the holes have been there since I created it).

>e
Tunnel
The wall stretches up high above, ending just before the ceiling. Rocks here and there seem to have fallen out of the wall over the ages it has stood in place, creating fist-sized holes in the walls (though as I believe I've made clear, it's not actually ancient because it's fake so the holes have been there since I created it).

>e
Library
Frustrated, you arrive in a room full of thousands and thousands of books. Just as the thought crosses your mind, you hear that voice again.

"It's not a room full of books, you imbecile. It's a library."

That would make sense. To the east you see a hallway continuing into the next room.

On the wall is a giant sign that says "PUZZLE INOPERABLE."

>w
Tunnel
The wall stretches up high above, ending just before the ceiling. Rocks here and there seem to have fallen out of the wall over the ages it has stood in place, creating fist-sized holes in the walls (though as I believe I've made clear, it's not actually ancient because it's fake so the holes have been there since I created it).

>w
Cobble Wall
A thin, wide room that ends abruptly in front you in an ancient cobblestone wall.

The wall stretches up high above, ending just before the ceiling. Rocks here and there seem to have fallen out of the wall over the ages it has stood in place, creating fist-sized holes in the walls (though as I believe I've made clear, it's not actually ancient because it's fake so the holes have been there since I created it).

To the north you can see the door you came through earlier.

>e
Tunnel
The wall stretches up high above, ending just before the ceiling. Rocks here and there seem to have fallen out of the wall over the ages it has stood in place, creating fist-sized holes in the walls (though as I believe I've made clear, it's not actually ancient because it's fake so the holes have been there since I created it).

>e
Library
A great library, full to the brim with boats. To the east you see a hallway continuing into the next room.

On the wall is a giant sign that says "PUZZLE INOPERABLE."

>w
Tunnel
The wall stretches up high above, ending just before the ceiling. Rocks here and there seem to have fallen out of the wall over the ages it has stood in place, creating fist-sized holes in the walls (though as I believe I've made clear, it's not actually ancient because it's fake so the holes have been there since I created it).

* * *

>take key
Taken.

>take fish and crumbs
angry fish: Taken.
crumbs: Taken.

>scoop pie
Taken.

>eat pie
You eat the pie. It's not bad for half-eaten pie from a bucket.

>unlock door with key
You unlock the first door.

* * *

>insert second key to center hole
I didn't understand that sentence.

>unlock center hole with key
Which do you mean, the second key or the first key?

>second
You insert the key you found into the hole in the wall, and hear a slight click. You turn the key to the left like a total dimwit, but correct yourself before the key snaps and twist the other direction. A small section of the wall eases forward with a sigh, revealing a passageway east.

>e
You push open the rocky door and move onwards through a short passageway.

Library
You arrive in a long room full of thousands and thousands of bookshelves, filled to the brim with dust-covered tomes. An ancient library, with books on topics much too complex for you to understand. The shelves continue further south.

Behind you to the west, you see a rocky door in the wall.

To the east you see a thick metal door, its industrial design a strange contrast to the otherwise ancient architecture you've encountered in this world so far.

Extruded from the door is a safe labeled "KEY", held closed by a 5-digit combination lock. There's a decimal point between the third and fourth digit of the number, which is odd for a combination lock.

* * *

>unlock door with third key
You unlock the third door.

>e
(first opening the third door)

Aquarium
You push through the door, and find yourself in a drastically different room with plain concrete walls and a black floor flecked with gray spots. The ceiling looks basically the same as the walls from where you're standing, but between you and me, it's a "living roof" - a roof with a grass on top.

To the west you see a thick metal door.

In the center of the room, taking up the majority of the space in the room is a giant fish tank. The first half meter of the tank is black glass, presumably hiding the inner workings of the tank. Above the base, the glass tank walls extend up for two meters. There does not appear to be a lid, but a sign next to the tank says in red, "NO MOLLUSCS IN THE TANK."

>go into tank
You get into the fish tank.

Half submerged in the sand at the bottom of the fish tank, a small metal object glints and sparkles in the light.

>exit
You get out of the fish tank.

Aquarium
A large room with plain concrete walls and a black floor flecked with gray spots. The ceiling looks basically the same as the walls from where you're standing, but between you and me, it's a "living roof" - a roof with a grass on top.

To the west you see a thick metal door.

In the center of the room, taking up the majority of the space in the room is a giant fish tank. The first half meter of the tank is black glass, presumably hiding the inner workings of the tank. Above the base, the glass tank walls extend up for two meters. There does not appear to be a lid, but a sign next to the tank says in red, "NO MOLLUSCS IN THE TANK."

>x tank
A large glash fishtank that takes up most of the space in the room. Seems to be around two and a half meters tall. A sign next to the tanks says in red, "NO MOLLUSCS IN THE TANK."

>x key
Which do you mean, the fourth key, the third key, the second key or the first key?

>x fourth key
A small silver key.

* * *

>x tank
A large glash fishtank that takes up most of the space in the room. Seems to be around two and a half meters tall. A sign next to the tanks says in red, "NO MOLLUSCS IN THE TANK."

* * *

>e
You reach into the hole and try to fit through, but the hole seems to end abruptly in a cold metal surface. Odd.

>ne
You squeeze yourself through the hole with surprising ease, but due to your inability to do anything properly you cause the entrance to cave in behind you. You find yourself in a bare cave, no larger than a fist, with no way to escape your tiny prison. Anyways, I'm not sticking around to watch you starve.

    *** The End ***

Would you like to RESTART, RESTORE a saved game, QUIT or UNDO the last command?

* * *

>undo
Cobble Wall
[Previous turn undone.]

>se
Teensy Cave of Fortune
Behind you to the northwest, light streams in from the tiny entrance.

In the dust below your feet, a small silver key glints in the dim light.

>take key
(the second key)
Taken.

>e
You can't go that way.

>look
Teensy Cave of Fortune
Behind you to the northwest, light streams in from the tiny entrance.

>nw
Cobble Wall
A thin, wide room that ends abruptly in front you in an ancient cobblestone wall. The wall stretches up high above, ending just before the ceiling. Rocks here and there seem to have fallen out of the wall over the ages it has stood in place, creating holes of varying sizes in the walls (though as I believe I've made clear, it's not actually ancient because it's fake so the holes have been there since I created it).

To the southeast, you can see a miniscule hole, barely larger than your average United State dime, a ten-cent coin, one tenth of a United States dollar, labeled formally as "one dime". The denomination was first authorized by the Coinage Act of 1792. The dime is the smallest in diameter and is the thinnest of all U.S. coins currently minted for circulation, being 0.705 inches (17.91 millimeters) in diameter and 0.053 in (1.35 mm) in thickness. The hole looks like that.

To the north you can see the door you came through earlier.

Directly in front of you - to the east, imbicile - you see a hole as average as yourself. It's so normal it's dissapointing.

In the northeast of the wall, you see a hole roughly the size of a fist, punched through the rock in a feat of strength far out of reach of one such as yourself.

>e
You reach into the hole and try to fit through, but the hole seems to end abruptly in a cold metal surface. Odd.

>put key in center hole
Which do you mean, the second key or the first key?

>put second key in center hole
That can't contain things.

>use second key in center hole
That's not a verb I recognise.

>unlock center hole with second key
You insert the key you found into the hole in the wall, and hear a slight click. You turn the key to the left like a total dimwit, but correct yourself before the key snaps and twist the other direction. A small section of the wall eases forward with a sigh, revealing a passageway west.

>e
You push open the rocky door and move onwards through a short passageway.

Library
Frustrated, you arrive in a room full of thousands and thousands of books. Just as the thought crosses your mind, you hear that voice again.

"It's not a room full of books, you imbecile. It's a library."

That would make sense. To the east you see a hallway continuing into the next room.

On the wall is a giant sign that says "PUZZLE INOPERABLE."

Directly in front of you - to the east, imbicile - you see a hole as average as yourself. It's so normal it's dissapointing.

* * *

>take key and crumbs
silver key: Taken.
crumbs: Taken.

>e
Great Room
A grand room built from giant blocks of a sand-colored stone, stacked up to a ceiling high above where a massive compass lays embedded in the rock.

Behind you to the west you see a hallway, hewn out of the stone, leading  to another room.

To the south, a small blue door is embedded in the rock.

Before you to the east, taking up almost the entire wall, is a great metal door painted a deep blue and patterned with yellow and white veins that run throughout. At the base of the door are four keyholes and four doorknobs.

>look at compass
A massive compass built into the rock of the ceiling. Four white triangles point towards the cardinal directions, and degrees between them are marked with smaller triangles in brown. It doesn't seem too practical, but it might help in some sort of text adventure.

>take compass
That's fixed in place.

>w
Cluttered Room
A room, half the size of the previous room, filled to the brim with chairs, folded tables, closed crates, and smaller tidbits scattered about.

Behind you to the east you see a hallway, hewn out of the stone, leading  to another room.

To the south, almost obscured behind a large gray couch, you see a door.

To your right you see a dented bucket overflowing with junk. Or maybe it's important items for progressing in the game.

The couch, lying to your left in front of the door, sags with (fake) age, and it's got tears in the tattered fabric in some places.

>unlock door with key
You unlock the square metal door.

* * *

>climb wall
You try and scramble up the wall, but the surface is too rough and you fall down pathetically

* * *

>take key and crumbs
silver key: Taken.
crumbs: Taken.

>unlock door with key
You unlock the square metal door.

>e
Great Room
A grand room built from giant blocks of a sand-colored stone, stacked up to a ceiling high above where a massive compass lays embedded in the rock.

Behind you to the west you see a hallway, hewn out of the stone, leading  to another room.

To the south, a small blue door is embedded in the rock.

Before you to the east, taking up almost the entire wall, is a great metal door painted a deep blue and patterned with yellow and white veins that run throughout. At the base of the door are four keyholes and four doorknobs.

* * *

>w
Cluttered Room
A room, half the size of the previous room, filled to the brim with chairs, folded tables, closed crates, and smaller tidbits scattered about.

Behind you to the east you see a hallway, hewn out of the stone, leading  to another room.

To the south, almost obscured behind a large gray couch, you see a door.

To your right you see a dented bucket overflowing with junk. Or maybe it's important items for progressing in the game.

The couch, lying to your left in front of the door, sags with (fake) age, and it's got tears in the tattered fabric in some places.

>s
(first opening the square metal door)

Cobble Wall
You push through the door, and find yourself in a tiny room.

To the north you can see the door you came through earlier.

In the center of the wall to the east, you can see a hole as average as yourself. It's so normal it's disappointing.

To the southeast, you can see a miniscule hole, barely larger than your average United State dime, a ten-cent coin, one tenth of a United States dollar, labeled formally as "one dime". The denomination was first authorized by the Coinage Act of 1792. The dime is the smallest in diameter and is the thinnest of all U.S. coins currently minted for circulation, being 0.705 inches (17.91 millimeters) in diameter and 0.053 in (1.35 mm) in thickness. The hole is that size.

To the northeast, you see a hole roughly the size of a fist, punched through the rock in a feat of strength, possibly in frustration, possibly with this game.

To your left a cobblestone wall stretches up high above, ending just before the ceiling. Rocks here and there seem to have fallen out of the wall over the ages it has stood in place, creating holes of varying sizes throughout the surface.

>x wall
A cobblestone wall stretching up almost to the ceiling. Some rocks in the walls seem to have fallen out of the wall over the ages it has stood in place, creating holes of varying sizes throughout the surface. Honestly it's just a bad wall.

* * *

>unlock center hole with gold key
You insert the key you found into the hole in the wall, and hear a slight click. You turn the key to the left like a total dimwit, but correct yourself before the key snaps and twist the other direction. A small section of the wall eases forward with a sigh, revealing a passageway east.

>e
You push open the rocky door and move onwards through a short passageway.

Library
You arrive in a long room full of thousands and thousands of bookshelves, filled to the brim with dust-covered tomes. An ancient library, with books on topics much too complex for you to understand. The shelves continue further south.

Behind you to the west, you see a rocky door in the wall.

To the east you see a thick metal door, its industrial design a strange contrast to the otherwise ancient architecture you've encountered in this world so far.

Extruded from the door is a safe labeled "KEY", held closed by a 5-digit combination lock. There's a decimal point between the third and fourth digit of the number, which is odd for a combination lock.

>s
Library (Shelf #1)
This section of the library is much the same as all the rest: shelves of books to either side, untouched books lying on their shelves. The main room is back to the north, and the shelves continue south.

Lying on the shelf to your left, a dustless green tome lies on its side. Gold lettering on its spine reads "The Dialogues of Plato." Lower down, its call number is printed: 184.2.

Standing on the right shelf, a tome with a suspicious amount of dust rests on the right shelf. Silver lettering on its spine reads "The Great Transformation," and below that its call number is written "200.9."

>take books
The Dialogues of Plato: Taken.
The Great Transformation: Taken.

* * *

>search couch
You search under the couch and under the cushions, and find a mountain of crumbs and a small key hiding underneath.

>take key and crumbs and fish
silver key: Taken.
crumbs: Taken.
angry fish: Taken.

>unlock door with key
You unlock the square metal door.

* * *

>w
Cluttered Room
A room, half the size of the previous room, filled to the brim with chairs, folded tables, closed crates, and smaller tidbits scattered about.

Behind you to the east you see a hallway, hewn out of the stone, leading  to another room.

To the south, almost obscured behind a large gray couch, you see a door.

To your right you see a dented bucket overflowing with junk. Or maybe it's important items for progressing in the game.

The couch, lying to your left in front of the door, sags with (fake) age, and it's got tears in the tattered fabric in some places.

>s
(first opening the square metal door)

Cobble Wall
You push through the door, and find yourself in a tiny room. To your left a cobblestone wall stretches up high above, ending just before the ceiling. Rocks here and there seem to have fallen out of the wall over the ages it has stood in place, creating holes of varying sizes throughout the surface.

To the north you can see the door you came through earlier.

In the center of the wall to the east, you can see a hole as average as yourself. It's so normal it's disappointing.

To the southeast, you can see a miniscule hole, barely larger than your average United State dime, a ten-cent coin, one tenth of a United States dollar, labeled formally as "one dime". The denomination was first authorized by the Coinage Act of 1792. The dime is the smallest in diameter and is the thinnest of all U.S. coins currently minted for circulation, being 0.705 inches (17.91 millimeters) in diameter and 0.053 in (1.35 mm) in thickness. The hole is that size.

To the northeast, you see a hole roughly the size of a fist, punched through the rock in a feat of strength, possibly in frustration, possibly with this game.

* * *

>enter 594.56 to safe
The safe lid pops open with a rush of air as the seal is broken. Inside, you see the copper key.

>take copper key
Taken.

>unlock door with key
Which do you mean, the copper key, the gold key or the silver key?

>copper key
You unlock the thick metal door.

>e
(first opening the thick metal door)

Aquarium
You push through the door, and find yourself in a drastically different room with plain concrete walls and a black floor flecked with gray spots. The ceiling looks basically the same as the walls from where you're standing, but between you and me, it's a "living roof" - a roof with a grass on top.

To the north, a door that almost looks like a miniature of the grand door from the Great Room - metal blue panels with white-and-yellow veins - is embedded in the rock. In the Middle Eastern style, the top of the door is a semicircle.

To the west you see a thick metal door.

In the center of the room, taking up the majority of the space in the room is a giant fish tank. The bottom half meter of the tank is black glass, presumably hiding the inner workings of the tank. Above the base, the glass tank walls extend up for another two meters. There does not appear to be a lid, but a sign next to the tank says in red, "NO MOLLUSCS IN THE TANK." Half submerged in the sand at the bottom of the fish tank, a small metal object glints and sparkles in the light.

>feed fish crumbs
The fish, though hesitant at first, wolfs down the crumbs in a matter of seconds and wiggles happily. I'm sure it would be inclined to help you out if you ever needed anything fish-related.

>go into tankl
You can't see any such thing.

>go into tank
You get into the tank.

* * *

>climb wall
You try and scramble up the wall, but the surface is too rough and you fall down pathetically

>se
Teensy Cave of Fortune
Behind you to the northwest, light streams in from the puny cave's entrance.

In the dust below your feet, a small gold key glints in the dim light.

* * *

>set lock to 594.56
The safe lid pops open with a rush of air as the seal is broken. Inside, you see the copper key.

>take copper key
Taken.

>unlock door with copper key
You unlock the thick metal door.

>e
(first opening the thick metal door)

Aquarium
You push through the door, and find yourself in a drastically different room with plain concrete walls and a black floor flecked with gray spots. The ceiling looks basically the same as the walls from where you're standing, but between you and me, it's a "living roof" - a roof with a grass on top.

To the north, a door that almost looks like a miniature of the grand door from the Great Room - metal blue panels with white-and-yellow veins - is embedded in the rock. In the Middle Eastern style, the top of the door is a semicircle.

To the west you see a thick metal door.

In the center of the room, taking up the majority of the space in the room is a giant fish tank. The bottom half meter of the tank is black glass, presumably hiding the inner workings of the tank. Above the base, the glass tank walls extend up for another two meters. There does not appear to be a lid, but a sign next to the tank says in red, "NO MOLLUSCS IN THE TANK." Half submerged in the sand at the bottom of the fish tank, a small metal object glints and sparkles in the light.

>feed fish the crumbs
(the angry fish the crumbs)
The fish, though hesitant at first, wolfs down the crumbs in a matter of seconds and wiggles happily. I'm sure it would be inclined to help you out if you ever needed anything fish-related.

>put fish in tank
(the happy fish in the fish tank)
You reach above the glass lip with a tentacle and drop the fish into the water. It gives you a little wink and dives to the bottom of the tank, disappearing into the reef. A few seconds later a small silver key flies out of the water and hits you square between the eyes, falling to the floor.

>take brass key
Taken.

>unlock door
Which do you mean, the small blue door or the thick metal door?

>unlock small blue door
What do you want to unlock the small blue door with?

>brass key
You unlock the small blue door.

>n
(first opening the small blue door)

Great Room
A grand room built from giant blocks of a sand-colored stone, stacked up to a ceiling high above where a massive compass lays embedded in the rock.

To the south, a small blue door is embedded in the rock.

Behind you to the west you see a hallway, hewn out of the stone, leading  to another room.

Before you to the east, taking up almost the entire wall, is a great metal door painted a deep blue and patterned with yellow and white veins that run throughout. At the base of the door are four keyholes and four doorknobs.

>unlock great metal door with silver key
You put the first key in the first keyhole. You turn it to the right, but it doesn't budge. You don't appear to be able to turn this key by itself.

>unlock great metal door with gold key
You put the gold key in the second keyhole. You turn it to the right, but it doesn't budge. You don't appear to be able to turn this key by itself.

>unlock great metal door with copper key
You put the copper key in the third keyhole. You turn it to the right, but it doesn't budge. You don't appear to be able to turn this key by itself.

>unlock great metal door with brass key
You put the brass key in the fourth keyhole. You turn it to the right, but it doesn't budge. You don't appear to be able to turn this key by itself.

>unlock door with tentacles
Which do you mean, the small blue door or the great metal door?

>unlock great metal door with tentacles
(first taking tentacles)
You reach out with your tentacles, and grasp the four keys and four doorknobs. All at once, you turn them to the right. The great doors ease open with a slight creek as the world around you fades into a white nothingness, and you stand alone in a smooth plane. You are a free octopus.

I'll release you for now. If you bring me a present next year I might consider turning you back into a human.

    *** The End ***

Would you like to RESTART, RESTORE a saved game, QUIT or UNDO the last command?

* * *

>enter 594.56 to safe
The safe lid pops open with a rush of air as the seal is broken. Inside, you see the copper key.

>take key
(the copper key)
Taken.

>unlock door with copper key
You unlock the thick metal door.

* * *

>go into tank
You approach the tank and scale the side with ease, slipping into the water within a matter of seconds. Suddenly, sirens go off, the room fills with a bright white light and the water quakes furiously. Armored cars and tanks smash through the walls, and the ceiling splits open for soldiers to slide in on ropes hanging from helicopters above. You're yanked out of the water, and the soldiers slap cuffs on your tentacles as they take you away.

That was quite foolish of you. Can't you read?

    *** The End ***

Would you like to RESTART, RESTORE a saved game, QUIT or UNDO the last command?

>undo
Aquarium
[Previous turn undone.]

>climb tank
You approach the tank and scale the side with ease, slipping into the water within a matter of seconds. Suddenly, sirens go off, the room fills with a bright white light and the water quakes furiously. Armored cars and tanks smash through the walls, and the ceiling splits open for soldiers to slide in on ropes hanging from helicopters above. You're yanked out of the water, and the soldiers slap cuffs on your tentacles as they take you away.

That was quite foolish of you. Can't you read?

    *** The End ***

Would you like to RESTART, RESTORE a saved game, QUIT or UNDO the last command?

>unod
Please give one of the answers above.

Would you like to RESTART, RESTORE a saved game, QUIT or UNDO the last command?

>undo
Aquarium
[Previous turn undone.]

* * *

>unlock center hole with second key
You can't see any such thing.

>e
Great Room
A grand room built from giant blocks of a sand-colored stone, stacked up to a ceiling high above where a massive compass lays embedded in the rock.

Behind you to the west you see a hallway, hewn out of the stone, leading  to another room.

Before you to the east, taking up almost the entire wall, is a great metal door painted a deep blue and patterned with yellow and white veins that run throughout. At the base of the door are four keyholes and four doorknobs.

* * *

>take key
You can't see any such thing.

>unlock door with third key
You can't see any such thing.

* * *

>e
(first opening Final Door)
It seems to be locked.

>feed fish the crumbs
You can't see any such thing.

>put fish in the tank
You can't see any such thing.

>i
You are carrying nothing.

* * *

>take crumbs
Taken.

>feed fish the crumbs
The fish, though hesitant at first, wolfs down the crumbs in a matter of seconds and wiggles happily. I'm sure it would be inclined to help you out if you ever needed anything fish-related.

>take fish
I don't suppose the happy fish would care for that.

* * *

>search couch
You search under the couch and under the cushions, and find a small key hiding underneath.

>search couch
You look through the couch, and find nothing. I made the couch bigger on the inside than the outside, so it's extra hard to find anything hiding inside.

* * *

>se
Teensy Cave of Fortune
To the southeast, you can see a miniscule hole, barely larger than your average United State dime, a ten-cent coin, one tenth of a United States dollar, labeled formally as "one dime". The denomination was first authorized by the Coinage Act of 1792. The dime is the smallest in diameter and is the thinnest of all U.S. coins currently minted for circulation, being 0.705 inches (17.91 millimeters) in diameter and 0.053 in (1.35 mm) in thickness. The hole looks like that.

>nw
Cobble Wall
A thin, wide room that ends abruptly in front you in an ancient cobblestone wall. The wall stretches up high above, ending just before the ceiling. Rocks here and there seem to have fallen out of the wall over the ages it has stood in place, creating holes of varying sizes in the walls (though as I believe I've made clear, it's not actually ancient because it's fake so the holes have been there since I created it).

To the southeast, you can see a miniscule hole, barely larger than your average United State dime, a ten-cent coin, one tenth of a United States dollar, labeled formally as "one dime". The denomination was first authorized by the Coinage Act of 1792. The dime is the smallest in diameter and is the thinnest of all U.S. coins currently minted for circulation, being 0.705 inches (17.91 millimeters) in diameter and 0.053 in (1.35 mm) in thickness. The hole looks like that.

To the north you can see the door you came through earlier.

Directly in front of you - to the east, imbicile - you see a hole as average as yourself. It's so normal it's dissapointing.

In the northeast of the wall, you see a hole roughly the size of a fist, punched through the rock in a feat of strength far out of reach of one such as yourself.

>ne
You squeeze yourself through the hole with surprising ease, but due to your inability to do anything properly you cause the entrance to cave in behind you. You find yourself in a bare cave, no larger than a fist. Once again, you're puzzled on how you fit. Anyways, I'm not sticking around to watch you starve.

    *** The End ***

Would you like to RESTART, RESTORE a saved game, QUIT or UNDO the last command?

>undo
Cobble Wall
[Previous turn undone.]

>look
Cobble Wall
A thin, wide room that ends abruptly in front you in an ancient cobblestone wall. The wall stretches up high above, ending just before the ceiling. Rocks here and there seem to have fallen out of the wall over the ages it has stood in place, creating holes of varying sizes in the walls (though as I believe I've made clear, it's not actually ancient because it's fake so the holes have been there since I created it).

To the southeast, you can see a miniscule hole, barely larger than your average United State dime, a ten-cent coin, one tenth of a United States dollar, labeled formally as "one dime". The denomination was first authorized by the Coinage Act of 1792. The dime is the smallest in diameter and is the thinnest of all U.S. coins currently minted for circulation, being 0.705 inches (17.91 millimeters) in diameter and 0.053 in (1.35 mm) in thickness. The hole looks like that.

To the north you can see the door you came through earlier.

Directly in front of you - to the east, imbicile - you see a hole as average as yourself. It's so normal it's dissapointing.

In the northeast of the wall, you see a hole roughly the size of a fist, punched through the rock in a feat of strength far out of reach of one such as yourself.

>e
(first opening center hole)
It seems to be locked.

>se
Teensy Cave of Fortune
To the southeast, you can see a miniscule hole, barely larger than your average United State dime, a ten-cent coin, one tenth of a United States dollar, labeled formally as "one dime". The denomination was first authorized by the Coinage Act of 1792. The dime is the smallest in diameter and is the thinnest of all U.S. coins currently minted for circulation, being 0.705 inches (17.91 millimeters) in diameter and 0.053 in (1.35 mm) in thickness. The hole looks like that.

* * *

>search couch
You look through the couch, and find nothing. I made the couch bigger on the inside than the outside, so it's extra hard to find anything hiding inside.

>take key
Taken.

>lok
That's not a verb I recognise.

>look
Cluttered Room
A room, half the size of the previous room, filled to the brim with chairs, folded tables, closed crates, and smaller tidbits scattered about.

Back to the east you see a hallway, hewn out of the stone, leading to another room.

To the south, almost obscured behind a large gray couch, you see a door.

To your left you see a dented bucket overflowing with junk. Or maybe it's important items for progressing in the game.

The couch lying in front of the door sags with (fake) age, and it's got tears in the tattered fabric in some places.

>go s
(first opening the first door)
It seems to be locked.

>unlock door with key
You unlock the first door.

* * *

>go through fist-sized hole
Anyways, I'm not sticking around to watch you starve.

    *** The End ***

Would you like to RESTART, RESTORE a saved game, QUIT or UNDO the last command?

* * *

>take key
Taken.

>go w
You can't go that way.

>w
You can't go that way.

>go through hallway
Great Room
A grand room built from giant blocks of a sand-colored stone, stacked up to a ceiling high above where a massive compass lays embedded in the rock.

Back to the west you see a hallway, hewn out of the stone, leading to another room.

Before you to the east, taking up almost the entire wall, is a great metal door painted a deep blue and patterned with yellow and white veins that run throughout. At the base of the door are eight large keyholes.

>go e
(first opening Eight-Lock Door)
It seems to be locked.

>w
Cluttered Room
A room, half the size of the previous room, filled to the brim with chairs, folded tables, closed crates, and smaller tidbits scattered about.

Back to the west you see a hallway, hewn out of the stone, leading to another room.

To the south, almost obscured behind a large gray couch, you see a closed door.

To your left you see a dented bucket overflowing with junk. Or maybe it's important items for progressing in the game.

The couch lying in front of the door sags with (fake) age, and it's got tears in the tattered fabric in some places.

>e
Great Room
A grand room built from giant blocks of a sand-colored stone, stacked up to a ceiling high above where a massive compass lays embedded in the rock.

Back to the west you see a hallway, hewn out of the stone, leading to another room.

Before you to the east, taking up almost the entire wall, is a great metal door painted a deep blue and patterned with yellow and white veins that run throughout. At the base of the door are eight large keyholes.

>w
Cluttered Room
A room, half the size of the previous room, filled to the brim with chairs, folded tables, closed crates, and smaller tidbits scattered about.

Back to the west you see a hallway, hewn out of the stone, leading to another room.

To the south, almost obscured behind a large gray couch, you see a closed door.

To your left you see a dented bucket overflowing with junk. Or maybe it's important items for progressing in the game.

The couch lying in front of the door sags with (fake) age, and it's got tears in the tattered fabric in some places.

* * *

>take key
Taken.

>open door with key
You unlock the first door.

>go s
(first opening the first door)

Maze
To the south, almost obscured behind a large gray couch, you see a closed door.

* * *

>take key
Taken.

>search couch
You search under the couch and under the cushions, and find a mountain of crumbs and a small key hiding underneath.

* * *

>take crumbs
You already have those.

>search couch
Though you've never been the best finder-of-things, particularly due to your atrocious eyesight and generally dreadful searching ability, you think the couch has nothing.

>feed angry fish the crumbs
do stuff

>x fish
The angriest fish you've ever seen. It's not in any bag or water, which might explain its mood.

>fish
That's not a verb I recognise.

>showme fish
happy fish - animal
location: in the bucket in the Cluttered Room
singular-named, improper-named; unlit, inedible, portable; male, neuter
list grouping key: none
printed name: "happy fish"
printed plural name: "animals"
indefinite article: "the"
description: "The angriest fish you've ever seen. It's not in any bag or water, which might explain its mood."
initial appearance: none
carrying capacity: 100

* * *

>search couch
Though you've never been the best finder-of-things, particularly due to your atrocious eyesight and generally dreadful searching ability, you think the couch has nothing.

>search couch
You look through the couch, and find nothing. I made the couch bigger on the inside than the outside, so it's extra hard to find anything hiding inside.

* * *

>look
Cluttered Room
A room, half the size of the previous room, filled to the brim with chairs, folded tables, closed crates, and smaller tidbits scattered about.

Back to the east you see a hallway, hewn out of the stone, leading to another room.

To the south, almost obscured behind a large gray couch, you see a closed door.

To your left you see a dented bucket overflowing with junk. Or maybe it's important items for progressing in the game.

The couch lying in front of the door sags with (fake) age, and it's got tears in the tattered fabric in some places.

>unlock door with key
You unlock the first door.

>look
Cluttered Room
A room, half the size of the previous room, filled to the brim with chairs, folded tables, closed crates, and smaller tidbits scattered about.

Back to the east you see a hallway, hewn out of the stone, leading to another room.

To the south, almost obscured behind a large gray couch, you see a closed door.

To your left you see a dented bucket overflowing with junk. Or maybe it's important items for progressing in the game.

The couch lying in front of the door sags with (fake) age, and it's got tears in the tattered fabric in some places.

>open door
You open the first door.

>look
Cluttered Room
A room, half the size of the previous room, filled to the brim with chairs, folded tables, closed crates, and smaller tidbits scattered about.

Back to the east you see a hallway, hewn out of the stone, leading to another room.

To the south, almost obscured behind a large gray couch, you see a open door.

To your left you see a dented bucket overflowing with junk. Or maybe it's important items for progressing in the game.

The couch lying in front of the door sags with (fake) age, and it's got tears in the tattered fabric in some places.

>s
Cobble Wall
You push through the door, and find yourself in a thin, wide room that ends abruptly in front you in an ancient cobblestone wall.

To the south, almost obscured behind a large gray couch, you see a open door.

The wall stretches up high above, ending just before the ceiling. Rocks here and there seem to have fallen out of the wall over the ages it has stood in place, creating fist-sized holes in the walls (though as I believe I've made clear, it's not actually ancient because it's fake so the holes have been there since I created it).

>climb wall
You try and scramble up the wall, but the surface is too rough and you fall down pathetically

* * *

>take crumbs
Taken.

>take pie
Taken.

>i
You are carrying:
  a half-eaten pie
  some crumbs

>eat pie
You eat the pie. It's not bad for half-eaten pie from a bucket.

>i
You are carrying:
  some crumbs

>eat crumbs
You eat them, and are forever lowered in my eyes you disgusted being. You should be ashamed, for what you have done right now is irredeemable.

>i
You are carrying nothing.

* * *

>take crumbs
Taken.

>x fish
The angriest fish you've ever seen. It's not in any bag or water, which might explain its mood.

>x bucjet
You can't see any such thing.

>x bucket
A medium-sized tin bucket, paint peeling from use. Or probably not, because this world doesn't really exist and I made it up.

In the bucket are an umbrella, skull, suspicious rag, half-eaten pie, rare great hornd bath towl cat, anime figurine, stack of sticky notes and the angry fish.

>feed fish the crumbs
do stuff

>x bucket
A medium-sized tin bucket, paint peeling from use. Or probably not, because this world doesn't really exist and I made it up.

In the bucket are an umbrella, skull, suspicious rag, half-eaten pie, rare great hornd bath towl cat, anime figurine, stack of sticky notes and the happy fish.

>x fish
The fish smiles at you happily when you look closer at it. Though the smile is sincere, it feels odd to see a fish smile with a full mouth of human teeth.

>take fish
I don't suppose the happy fish would care for that.

* * *

>search couch
You search throughout the couch lazily and find only crumbs. You could scoop them up I guess?

>take crumbs and key and fish
You can't see any such thing.

>unlock door with key
You can't see any such thing.

* * *

>e
Great Room
A grand room built from giant blocks of a sand-colored stone, stacked up to a ceiling high above where a massive compass lays embedded in the rock.

Behind you to the west you see a hallway, hewn out of the stone, leading  to another room.

To the south, a small blue door is embedded in the rock.

Before you to the east, taking up almost the entire wall, is a great metal door painted a deep blue and patterned with yellow and white veins that run throughout. At the base of the door are four keyholes and four doorknobs.

>set lock to 596.54
You can't see any such thing.

>set lock to 594.56
You can't see any such thing.

* * *

>put fish in tank
You can't see any such thing.

>take key
You can't see any such thing.

>unlock blue door
What do you want to unlock the small blue door with?

>unlock blue door with fourth key
You can't see any such thing.

* * *

>n
You can't go that way.

>unlock door with fourth key
Which do you mean, the small blue door, Final Door or the hidden door stuff?

>Final door
You can't see any such thing.

>unlock Final Door with the fourth key
You can't see any such thing.

* * *

>search couch
You search throughout the couch lazily and find only crumbs. You could scoop them up I guess?

>take eky
You can't see any such thing.

>take key
Taken.

* * *

>take key
(the second key)
Taken.

>unlock center hole with key
You can't see any such thing.

>nw
Cobble Wall
A tiny room that ends abruptly to your left in an ancient cobblestone wall. The wall stretches up high above, ending just before the ceiling. Rocks here and there seem to have fallen out of the wall over the ages it has stood in place, creating holes of varying sizes in the walls (though as I believe I've made clear, it's not actually ancient because it's fake so the holes have been there since I created it).

To the southeast, you can see a miniscule hole, barely larger than your average United State dime, a ten-cent coin, one tenth of a United States dollar, labeled formally as "one dime". The denomination was first authorized by the Coinage Act of 1792. The dime is the smallest in diameter and is the thinnest of all U.S. coins currently minted for circulation, being 0.705 inches (17.91 millimeters) in diameter and 0.053 in (1.35 mm) in thickness. The hole looks like that.

To the north you can see the door you came through earlier.

In the center of the wall to the east, you can see a hole as average as yourself. It's so normal it's dissapointing.

In the northeast of the wall, you see a hole roughly the size of a fist, punched through the rock in a feat of strength far out of reach of one such as yourself.

* * *

>s
Library (Shelf #1)
This section of the library is much the same as all the rest: shelves of books to either side, untouched books lying on their shelves.

Lying on the shelf to your left, a dustless green tome lies on its side. Gold lettering on its spine reads "The Dialogues of Plato." Lower down, its call number is printed: 184.2.

Standing on the right shelf, a tome with a suspicious amount of dust rests on the right shelf. Silver lettering on its spine reads "The Great Transformation," and below that its call number is written "200.9."

>x dialogues
You don't know much about this book because you're an fool, but luckily it comes with a description on the back.

"Socrates' ancient words are still true, and the ideas found in Plato's Dialogues still form the foundation of a thinking person's education. This superb collection contains excellent contemporary translations selected for their clarity and accessibility to today's reader, as well as an incisive introduction by Erich Segal, which reveals Plato's life and clarifies the philosophical issues examined in each dialogue. The first four dialogues recount the trial and execution of Socrates-the extraordinary tragedy that changed Plato's life and forever altered the course of Western thought. Other dialogues create a rich tableau of intellectual life in Athens in the fourth century b.c., and examine such timeless-and timely-issues as the nature of virtue and love, knowledge and truth, society and the individual. Resounding with the humor and astounding brilliance of Socrates, the immortal iconoclast, these great works remain powerful, probing, and essential."

Title - The Dialogues of Plato
Call number: 184.2

* * *

>take key
Taken.

>search couch
You search throughout the couch lazily and find only crumbs.
You could scoop them up I guess?

* * *

>unlock door with key
You unlock the first door.

>w
You can't go that way.

>look
Cluttered Room
A room, half the size of the previous room, filled to the brim with chairs, folded tables, closed crates, and smaller tidbits scattered about.

Back to the east you see a hallway, hewn out of the stone, leading to another room.

To the south, almost obscured behind a large gray couch, you see a door.

To your left you see a dented bucket overflowing with junk. Or maybe it's important items for progressing in the game.

The couch lying in front of the door sags with (fake) age, and it's got tears in the tattered fabric in some places.

>s
(first opening the first door)

Cobble Wall
You push through the door, and find yourself in a thin, wide room that ends abruptly in front you in an ancient cobblestone wall.

To the north you can see the door you came through earlier.

The wall stretches up high above, ending just before the ceiling. Rocks here and there seem to have fallen out of the wall over the ages it has stood in place, creating fist-sized holes in the walls (though as I believe I've made clear, it's not actually ancient because it's fake so the holes have been there since I created it).

* * *

>go through hole
You squeeze yourself through the hole with surprising ease, but due to your inability to do anything properly you cause the entrance to cave in behind you. You find yourself in a bare cave, no larger than a fist. Once again, you're puzzled on how you fit. Anyways, I'm not sticking around to watch you starve.

    *** The End ***

Would you like to RESTART, RESTORE a saved game, QUIT or UNDO the last command?

>undo
Cobble Wall
[Previous turn undone.]

>look
Cobble Wall
A thin, wide room that ends abruptly in front you in an ancient cobblestone wall. The wall stretches up high above, ending just before the ceiling. Rocks here and there seem to have fallen out of the wall over the ages it has stood in place, creating holes of varying sizes in the walls (though as I believe I've made clear, it's not actually ancient because it's fake so the holes have been there since I created it).

To the north you can see the door you came through earlier.

You can also see fist-sized hole here.

* * *

>insert key into center hole
Which do you mean, the second key or the first key?

>insert second key into center hole
That can't contain things.

* * *

>insert key into center hole
Which do you mean, the second key or the first key?

>second
You insert the key you found into the hole in the wall, and hear a slight click. You turn the key to the left like a total dimwit, but correct yourself before the key snaps and twist the other direction. A small section of the wall eases forward with a sigh, revealing a passageway east.

* * *

>unlock door with third key
You unlock the third door.

>e
(first opening the third door)

Aquarium
You push through the door, and find yourself in a drastically different room with plain concrete walls and a black floor flecked with gray spots. The ceiling looks basically the same as the walls from where you're standing, but between you and me, it's a "living roof" - a roof with a grass on top.

To the west you see a thick metal door.

In the center of the room, taking up the majority of the space in the room is a giant fishtank. The first half meter of the tank is an black wall, presumably hiding the inner workings of the tank. Above the base, the glass tank walls extend up for two meters. There does not appear to be a lid, but a sign next to the tanks says in red, "NO MOLLUSCS IN THE TANK."

>x tank
A large glash fishtank that takes up most of the space in the room. Seems to be around two and a half meters tall. A sign next to the tanks says in red, "NO MOLLUSCS IN THE TANK."

In the fish tank is the fourth key.

* * *

>n
Library (Shelf #2)
This section of the library is much the same as all the rest: shelves of books to either side, untouched books lying on their shelves. The library continues both north and south.

Directly in front of you, a white novel rests on the ground. Black type on its cover reads "Outliers." On its spine a call number is printed: 302.6.

Peeking over the edge of the right shelf, a yellow book hangs above your head face-down. From where you stand, you can see bold black-and-blue lettering, "Because Internet." On its spine, a call number reads "402.231."

>n
Library (Shelf #1)
This section of the library is much the same as all the rest: shelves of books to either side, untouched books lying on their shelves. The main room is back to the north, and the shelves continue south.

Lying on the shelf to your left, a dustless green tome lies on its side. Gold lettering on its spine reads "The Dialogues of Plato." Lower down, its call number is printed: 184.2.

Standing on the right shelf, a tome with a suspicious amount of dust rests on the right shelf. Silver lettering on its spine reads "The Great Transformation," and below that its call number is written "200.9."

* * *

>n
Library
A great library, full to the brim with books. The shelves continue further south.

Behind you to the west, you see a rocky door in the wall.

To the east you see a thick metal door, its industrial design a strange contrast to the otherwise ancient architecture you've encountered in this world so far.

Extruded from the door is a safe labeled "KEY", held closed by a 5-digit combination lock. There's a decimal point between the third and fourth digit of the number, which is odd for a combination lock.

>set safe to 594.56
The safe lid pops open with a rush of air as the seal is broken. Inside, you see the third key.

>take key
(the third key)
Taken.

>unlock door with key
Which do you mean, the third key, the second key or the first key?

>third
You unlock the third door.

>e
(first opening the third door)

Mirror Maze
You slide the bottom of the tunnel, and immediately are confronted by... octopi. Hundreds of octopi in every direction. You leap to get out of the way and let out a high-pitched shriek.

The octopi ripple as a laugh shakes the room.

You look closer at the octopi and see... mirrors. Boaz turned you into an octopus, and brought you to a mirror maze. Everywhere you look, octopi follow your gaze - eight tentacles sliding over the ground as you move. To the north you see a hallway continuing into the next room.

On the wall is a giant sign that says "PUZZLE INOPERABLE."

To the west you see a thick metal door.

* * *

>third
You unlock the third door.

>e
(first opening the third door)

Aquarium
You push through the door, and find yourself in a drastically different room with plain concrete walls and a black floor flecked with gray spots. The ceiling looks basically the same as the walls from where you're standing, but between you and me, it's a "living roof" - a roof with a grass on top.

To the west you see a thick metal door.

In the center of the room, taking up the majority of the space in the room is a giant fishtank. The first half meter of the tank is an black wall, presumably hiding the inner workings of the tank. Above the base, the glass tank walls extend up for two meters, where they end at a mesh lid.

>x tank
A large fishtank that takes up most of the space in the room. Seems to be around two and a half meters tall, and capped with a mesh lid.

In the fish tank is the fourth key.

* * *

>x aquarium
You can't see any such thing.

>x fish tank
In the fish tank is the fourth key.

* * *

>s
Library (Shelf #1)
This section of the library is much the same as all the rest: shelves of books to either side, untouched books lying on their shelves.

Lying on the shelf to your left, a dustless green tome lies on its side. Gold lettering on its spine reads "The Dialogues of Plato." Lower down, its call number is printed: 184.2.

Standing on the right shelf, a tome with a suspicious amount of dust rests on the right shelf. Silver lettering on its spine reads "The Great Transformation," and below that its call number is written "200.9."

>n
Library
A great library, full to the brim with books. The shelves continue further south.

Behind you to the west, you see a rocky door in the wall.

To the east you see a thick metal door, its industrial design a strange contrast to the otherwise ancient design you've encountered in this world so far.

* * *

>s
Library (Shelf #1)
This section of the library is much the same as all the rest: shelves of books to either side, untouched books lying on their shelves.

Lying on the shelf to your left, a dustless green tome lies on its side. Gold lettering on its spine reads "The Dialogues of Plato." Lower down, its call number is printed: 184.2.

Standing on the right shelf, a tome with a suspicious amount of dust rests on the right shelf. Silver lettering on its spine reads "The Great Transformation," and below that its call number is written "200.9."

>take plato
Taken.

>x plato
You don't know much about this book because you're an fool, but luckily it comes with a description on the back.

"Socrates' ancient words are still true, and the ideas found in Plato's Dialogues still form the foundation of a thinking person's education. This superb collection contains excellent contemporary translations selected for their clarity and accessibility to today's reader, as well as an incisive introduction by Erich Segal, which reveals Plato's life and clarifies the philosophical issues examined in each dialogue. The first four dialogues recount the trial and execution of Socrates-the extraordinary tragedy that changed Plato's life and forever altered the course of Western thought. Other dialogues create a rich tableau of intellectual life in Athens in the fourth century b.c., and examine such timeless-and timely-issues as the nature of virtue and love, knowledge and truth, society and the individual. Resounding with the humor and astounding brilliance of Socrates, the immortal iconoclast, these great works remain powerful, probing, and essential."

Title - The Dialogues of Plato
Call number - 184.2

>x transformation
An analysis of the peoples and religions of four distinct regions (China, India, Israel, and Greece) in the ninth century BCE, written by Karen Armstrong. Currently has 3,467 ratings at an average of 4.03 stars on Goodreads.

Title - The Great Transformation
Call number - 200.9

>s
Library (Shelf #2)
This section of the library is much the same as all the rest: shelves of books to either side, untouched books lying on their shelves.

Directly in front of you, a white novel rests on the ground. Black type on its cover reads "Outliers." On its spine a call number is printed: 302.6.

Peeking over the edge of the right shelf, a yellow book hangs above your head face-down. From where you stand, you can see bold black-and-blue lettering, "Because Internet." On its spine, a call number reads "402.231."

>drop plato
Dropped.

>look
Library (Shelf #2)
This section of the library is much the same as all the rest: shelves of books to either side, untouched books lying on their shelves.

Directly in front of you, a white novel rests on the ground. Black type on its cover reads "Outliers." On its spine a call number is printed: 302.6.

Peeking over the edge of the right shelf, a yellow book hangs above your head face-down. From where you stand, you can see bold black-and-blue lettering, "Because Internet." On its spine, a call number reads "402.231."

You can also see The Dialogues of Plato here.

>x plato
You don't know much about this book because you're an fool, but luckily it comes with a description on the back.

"Socrates' ancient words are still true, and the ideas found in Plato's Dialogues still form the foundation of a thinking person's education. This superb collection contains excellent contemporary translations selected for their clarity and accessibility to today's reader, as well as an incisive introduction by Erich Segal, which reveals Plato's life and clarifies the philosophical issues examined in each dialogue. The first four dialogues recount the trial and execution of Socrates-the extraordinary tragedy that changed Plato's life and forever altered the course of Western thought. Other dialogues create a rich tableau of intellectual life in Athens in the fourth century b.c., and examine such timeless-and timely-issues as the nature of virtue and love, knowledge and truth, society and the individual. Resounding with the humor and astounding brilliance of Socrates, the immortal iconoclast, these great works remain powerful, probing, and essential."

Title - The Dialogues of Plato
Call number - 184.2

* * *

>take key
(the second key)
Taken.

>x second key
A small silver key emblazoned with the English letter "O".

>look
Teensy Cave of Fortune
Behind you to the northwest, light streams in from the tiny entrance.

* * *

>unlock hole
Which do you mean, dime-sized hole, the center hole or fist-sized hole?

>unlock center hole
What do you want to unlock the center hole with?

>unlock center hole with key
Which do you mean, the second key or the first key?

>unlock center hole with second key
You unlock the center hole.

>go through center hole
(first opening the center hole)

Library
Frustrated, you arrive in a room full of thousands and thousands of books. Just as the thought crosses your mind, you hear that voice again.

"It's not a room full of books, you imbecile. It's a library."

That would make sense. To the east you see a hallway continuing into the next room.

On the wall is a giant sign that says "PUZZLE INOPERABLE."

Directly in front of you - to the east, imbicile - you see a hole as average as yourself. It's so normal it's dissapointing.

* * *

>search couch
You search throughout the couch lazily and find only crumbs. You could scoop them up I guess?

>take key and crumbs
first key: Taken.
crumbs: Taken.

>take fish
Taken.

>unlock door with second key
You can't see any such thing.

>unlock door with key
You unlock the first door.

* * *

>take key
(the third key)
Taken.

I beg your pardon?

>unlock door with third key
You unlock the third door.

* * *

>feed fish the crumbs
(the angry fish the crumbs)
The fish, though hesitant at first, wolfs down the crumbs in a matter of seconds and wiggles happily. I'm sure it would be inclined to help you out if you ever needed anything fish-related.

>put fish in tnak
You can't see any such thing.

>put fish in tank
(the happy fish in the fish tank)
You reach above the glass lip with a tentacle and drop the fish into the water. It gives you a little wink and dives to the bottom of the tank, disappearing into the reef. A few seconds later a small silver key flies out of the water and hit you square between the eyes, falling to the floor.

>take key
(the fourth key)
Taken.

* * *

>n
(first opening the small blue door)

Great Room
A grand room built from giant blocks of a sand-colored stone, stacked up to a ceiling high above where a massive compass lays embedded in the rock.

To the south, a small blue door is embedded in the rock.

Behind you to the west you see a hallway, hewn out of the stone, leading  to another room.

Before you to the east, taking up almost the entire wall, is a great metal door painted a deep blue and patterned with yellow and white veins that run throughout. At the base of the door are four keyholes and four doorknobs.

>unlock final door
What do you want to unlock Final Door with?

>unlock final door with first key
You put the first key in the first keyhole. You turn it to the right, but it doesn't budge. Maybe you should force it, so it breaks and you get stuck here forever.

>i
You are carrying:
  the fourth key
  the third key
  the second key

>unlock final door with second key
You put the second key in the second keyhole. You turn it to the right, but it doesn't budge. Maybe you should force it, so it breaks and you get stuck here forever.

>i
You are carrying:
  the fourth key
  the third key

>unlock final door with third key
You put the third key in the third keyhole. You turn it to the right, but it doesn't budge. Maybe you should force it, so it breaks and you get stuck here forever.

>unlock final door with fourth key
You put the fourth key in the fourth keyhole. You turn it to the right, but it doesn't budge. Maybe you should force it, so it breaks and you get stuck here forever.

>i
You are carrying nothing.

>look
Great Room
A grand room built from giant blocks of a sand-colored stone, stacked up to a ceiling high above where a massive compass lays embedded in the rock.

To the south, a small blue door is embedded in the rock.

Behind you to the west you see a hallway, hewn out of the stone, leading  to another room.

Before you to the east, taking up almost the entire wall, is a great metal door painted a deep blue and patterned with yellow and white veins that run throughout. At the base of the door are four keyholes and four doorknobs.

* * *

>search couch
You search throughout the couch lazily and find only crumbs. You could scoop them up I guess?

>take key and crumbs and fish
first key: Taken.
crumbs: Taken.
angry fish: Taken.

>unlock door with key, go s, go se, take key, go nw, unlock center hole with second key, go e, set lock to 594.56, take key, unlock door with third key, go e, feed fish the crumbs, put fish in tank, take key, unlock blue door with fourth key, go n
You can't use multiple objects with that verb.

>unlock door with key
You unlock the first door.

* * *

>feed fish the crumbs
(the angry fish the crumbs)
The fish, though hesitant at first, wolfs down the crumbs in a matter of seconds and wiggles happily. I'm sure it would be inclined to help you out if you ever needed anything fish-related.

>put fish in tank
(the happy fish in the fish tank)
You reach above the glass lip with a tentacle and drop the fish into the water. It gives you a little wink and dives to the bottom of the tank, disappearing into the reef. A few seconds later a small silver key flies out of the water and hit you square between the eyes, falling to the floor.

* * *

>take key
(the fourth key)
Taken.

>unlock blue door with fourth key
You unlock the small blue door.

* * *

>n
(first opening the small blue door)

Great Room
A grand room built from giant blocks of a sand-colored stone, stacked up to a ceiling high above where a massive compass lays embedded in the rock.

To the south, a small blue door is embedded in the rock.

Behind you to the west you see a hallway, hewn out of the stone, leading  to another room.

Before you to the east, taking up almost the entire wall, is a great metal door painted a deep blue and patterned with yellow and white veins that run throughout. At the base of the door are four keyholes and four doorknobs.

>unlock final door with first key
You put the first key in the first keyhole. You turn it to the right, but it doesn't budge. Maybe you should force it, so it breaks and you get stuck here forever.

>look
Great Room
A grand room built from giant blocks of a sand-colored stone, stacked up to a ceiling high above where a massive compass lays embedded in the rock.

To the south, a small blue door is embedded in the rock.

Behind you to the west you see a hallway, hewn out of the stone, leading  to another room.

Before you to the east, taking up almost the entire wall, is a great metal door painted a deep blue and patterned with yellow and white veins that run throughout. At the base of the door are four keyholes and four doorknobs.
In the first keyhole is a small silver key.

>unlock final door with second key
You put the second key in the second keyhole. You turn it to the right, but it doesn't budge. Maybe you should force it, so it breaks and you get stuck here forever.

>unlock final door with third key
You put the third key in the third keyhole. You turn it to the right, but it doesn't budge. Maybe you should force it, so it breaks and you get stuck here forever.

>look
Great Room
A grand room built from giant blocks of a sand-colored stone, stacked up to a ceiling high above where a massive compass lays embedded in the rock.

To the south, a small blue door is embedded in the rock.

Behind you to the west you see a hallway, hewn out of the stone, leading  to another room.

Before you to the east, taking up almost the entire wall, is a great metal door painted a deep blue and patterned with yellow and white veins that run throughout. At the base of the door are four keyholes and four doorknobs.
In the first keyhole is a small silver key.
In the second keyhole is a small silver key.
In the third keyhole is a small silver key.

>unlock final door with fourth key
You put the fourth key in the fourth keyhole. You turn it to the right, but it doesn't budge. Maybe you should force it, so it breaks and you get stuck here forever.

* * *

>i
You are carrying nothing.

>x hidden utilities
I only understood you as far as wanting to examine the hidden door stuff.

>x hidden door stuff
In the hidden door stuff are a first knob, a second knob, a third knob, a fourth knob, a first keyhole, a second keyhole, a third keyhole and a fourth keyhole.

* * *

>search couch
You search throughout the couch lazily and find only crumbs. You could scoop them up I guess?

>take key and pie and fish
first key: Taken.
half-eaten pie: Taken.
angry fish: Taken.

>unlock door with key
You unlock the first door.

* * *

>feed fish pie
(the angry fish the half-eaten pie)
The fish, though hesitant at first, wolfs down the half-eaten pie in a matter of seconds and wiggles happily. I'm sure it would be inclined to help you out if you ever needed anything fish-related.

>put fish in tank
(the happy fish in the fish tank)
You reach above the glass lip with a tentacle and drop the fish into the water. It gives you a little wink and dives to the bottom of the tank, dissappearing into the reef. A few seconds later, a pair of keys fly out of the water and hit you square between the eyes.

>unlock door with fourth key
Which do you mean, the fourth door or the third door?

>fourth
You unlock the fourth door.

>n
(first opening the fourth door)

Great Room
A grand room built from giant blocks of a sand-colored stone, stacked up to a ceiling high above where a massive compass lays embedded in the rock.

To the south, a small blue door is embedded in the rock.

Behind you to the west you see a hallway, hewn out of the stone, leading  to another room.

Before you to the east, taking up almost the entire wall, is a great metal door painted a deep blue and patterned with yellow and white veins that run throughout. At the base of the door are four keyholes and four doorknobs.

* * *

>put first key in first keyhole
You put the first key into first keyhole.

>put second key in second keyhole
You put the second key into second keyhole.

>put third key in third keyhole
You put the third key into third keyhole.

>use tentacles to unlock final door
You reach out with your tentacles, and grasp the four keys and four doorknobs. All at once, you turn them to the right. The great doors ease open with a slight creek as the world around you fades into a white nothingness, and you stand alone in a smooth plane. You against me.

I'll release you for now. If you bring me a present next year I might consider turning you back into a human.

    *** The End ***

Would you like to RESTART, RESTORE a saved game, QUIT or UNDO the last command?

>undo
Great Room
[Previous turn undone.]

>i
You are carrying:
  the fourth key

* * *

>unlock door with second key
That's unlocked at the moment.

>unlock center hole with second key
You insert the key you found into the hole in the wall, and hear a slight click. You turn the key to the left like a total dimwit, but correct yourself before the key snaps and twist the other direction. A small section of the wall eases forward with a sigh, revealing a passageway east.

* * *

>feed fish pie
(the angry fish the half-eaten pie)
The fish, though hesitant at first, wolfs down the half-eaten pie in a matter of seconds and wiggles happily. I'm sure it would be inclined to help you out if you ever needed anything fish-related.

>i
You are carrying:
  the third key
  the second key
  the happy fish
  the first key

>put fish in tank
(the happy fish in the fish tank)
You reach above the glass lip with a tentacle and drop the fish into the water. It gives you a little wink and dives to the bottom of the tank, dissappearing into the reef. A few seconds later, a pair of keys fly out of the water and hit you square between the eyes.

>i
You are carrying:
  the fourth key
  the third key
  the second key
  the first key

* * *

>search couhc
You can't see any such thing.

>search couch
You search throughout the couch lazily and find only crumbs. You could scoop them up I guess?

Though you've never been the best finder-of-things, particularly due to your atrocious eyesight and generally dreadful searching ability, you think the couch has the crumbs.

>take crumbs
Taken.

>feed fish the crumbs
The fish, though hesitant at first, wolfs down the happy fish in a matter of seconds and wiggles happily. I'm sure it would be inclined to help you out if you ever needed anything fish-related.

* * *

>search the couch
Crumbs

* * *

>take bitch
That's hardly portable.

>x bitch
You see nothing special about the bitch.

* * *

>take dingus
That's hardly portable.

>x dingus
A refreshing soda pop.

* * *

>take fish
Taken.

>take angry fish
I don't suppose the angry fish would care for that.

>take pei
You can't see any such thing.

>take pie
Taken.

>feed fish pie
do stuff

>feed pie fish
You can only do that to something animate.

* * *

>take fish
Taken.

>x fish
A tiny fish, undoubtably the angriest fish you've ever seen. It's not in any bag or water, which might explain its mood. Or maybe it's just not hungry - after all, you're not you when you're hungry.

>put fish in bucket
You put the angry fish into the bucket.

>x bucket
A medium-sized tin bucket, paint peeling from use. Or probably not, because this world doesn't really exist and I made it up.

In the bucket are the angry fish, an umbrella, skull, suspicious rag, half-eaten pie, rare great hornd bath towl cat, anime figurine and stack of sticky notes.

>take fish
Taken.

>take pie
Taken.

>feed fish pie
The fish, though hesitant at first, wolfs down half-eaten pie in a matter of seconds and wiggles happily. I'm sure it would be inclined to help you out if you ever needed anything fish-related.

* * *

>take fuckassbitch
That's hardly portable.

* * *

>take newspaper
That's hardly portable.

* * *

>take penis
That's hardly portable.

* * *

>take pie
Taken.

>take fish
Taken.

>i
You are carrying:
  the angry fish
  a half-eaten pie

>feed fish pie
The fish, though hesitant at first, wolfs down the half-eaten pie in a matter of seconds and wiggles happily. I'm sure it would be inclined to help you out if you ever needed anything fish-related.

>i
You are carrying:
  the happy fish

* * *

>take pie and fish
half-eaten pie: Taken.
angry fish: Taken.

>e
Great Room
A grand room built from giant blocks of a sand-colored stone, stacked up to a ceiling high above where a massive compass lays embedded in the rock.

Behind you to the west you see a hallway, hewn out of the stone, leading  to another room.

To the south, a small blue door is embedded in the rock.

Before you to the east, taking up almost the entire wall, is a great metal door painted a deep blue and patterned with yellow and white veins that run throughout. At the base of the door are four keyholes and four doorknobs.

>put pie in first keyhole
You put the half-eaten pie into first keyhole.

>put fish in first keyhole
There is no more room in first keyhole.

>x first keyhole
In first keyhole is a half-eaten pie.

>take pie
Taken.

* * *

>wear skull
(first taking the skull)
You try to put it on, but it doesn't quite fit. Odd.

>i
You are carrying:
  a skull

* * *

>x bucket
A medium-sized tin bucket, paint peeling from use. Or probably not, because this world doesn't really exist and I made it up.

In the bucket are an umbrella, a skull, a suspicious rag, a half-eaten pie, a rare great hornd bath towl cat, an anime figurine, a stack of sticky notes and the angry fish.

>take fish
Taken.

* * *

>take pie
Taken.

>feed fish the pie
The fish, though hesitant at first, wolfs down the half-eaten pie in a matter of seconds and wiggles happily. I'm sure it would be inclined to help you out if you ever needed anything fish-related.

>x fish
The tiny fish smiles at you happily when you look closer at it. Though the smile is sincere, it feels odd to see a fish smile with a full mouth of human teeth.

>put fish in bucket
You put the happy fish into the bucket.

>take fish
Taken.

* * *

>x bucket
A medium-sized tin bucket, paint peeling from use. Or probably not, because this world doesn't really exist and I made it up.

In the bucket are an umbrella, a skull, a suspicious rag, a half-eaten pie, a rare great hornd bath towl cat, an anime figurine, a stack of sticky notes and the angry fish.

>take pie
Taken.

>eat pie
You eat half-eaten pie. Not bad.

* * *

>take pie
Taken.

>feed pie to fish
The angry fish doesn't seem interested.

* * *

>x bucket
A medium-sized tin bucket, paint peeling from use. Or probably not, because this world doesn't really exist and I made it up.

In the bucket are an umbrella, a skull, a suspicious rag, a half-eaten pie, a rare great hornd bath towl cat, an anime figurine, a stack of sticky notes and the angry fish.

>take umbrella
Taken.

>take skull
Taken.

>take rag
Taken.

>take pie and towl cat and figurine
half-eaten pie: Taken.
rare great hornd bath towl cat: Taken.
anime figurine: Taken.

>take notes and fish
stack of sticky notes: Taken.
angry fish: Taken.

>i
You are carrying:
  angry fish
  stack of sticky notes
  anime figurine
  rare great hornd bath towl cat
  half-eaten pie
  suspicious rag
  skull
  an umbrella

>x bucket
A medium-sized tin bucket, paint peeling from use. Or probably not, because this world doesn't really exist and I made it up.

>take bucket
You're carrying too many things already.

* * *

>x bucket
A medium-sized tin bucket, paint peeling from use. Or probably not, because this world doesn't really exist and I made it up.

In the bucket are an umbrella, a skull, a suspicious rag, a half-eaten pie, a rare great hornd bath towl cat, an anime figurine, a stack of sticky notes and the angry fish.

>take umbrella and skull and rag and pie and cat and figurine and notes and fish
umbrella: Taken.
skull: Taken.
suspicious rag: Taken.
half-eaten pie: Taken.
rare great hornd bath towl cat: Taken.
anime figurine: Taken.
stack of sticky notes: Taken.
angry fish: Taken.

>look
Cluttered Room
A room, half the size of the previous room, filled to the brim with chairs, folded tables, closed crates, and smaller tidbits scattered about.

To the south, almost obscured behind a large gray couch, you see a closed door.

To your left you see a dented bucket. Or maybe it's important items for progressing in the game.

The couch lying in front of the door sags with (fake) age, and it's got tears in the tattered fabric in some places.

>x bucket
A medium-sized tin bucket, paint peeling from use. Or probably not, because this world doesn't really exist and I made it up.

>x couch
On closer inspection, you realize that's it your couch. I stole it from the real world to put in my game.

>search couch
You search throughout the couch lazily and find only crumbs.
Fun fact: they're the crumbs from the pie. I ate it on the couch and threw it in the bucket before transporting you here.
You could scoop them up I guess?

>take crumbs
You're carrying too many things already.

>i
You are carrying:
  angry fish
  stack of sticky notes
  anime figurine
  rare great hornd bath towl cat
  half-eaten pie
  suspicious rag
  skull
  an umbrella

>wear skull
You try to put it on, but it doesn't quite fit. Odd.

>drop skull
Dropped.

>take crumbs
Taken.

>x couch
On closer inspection, you realize that's it your couch. I stole it from the real world to put in my game.

>search couch
You look through the couch, and find nothing. I made the couch bigger on the inside than the outside, so it's extra hard to find anything hiding inside.

* * *

>search couch
You search under the couch and under the cushions, and find a small key hiding underneath.

>take key
You're carrying too many things already.

>i
You are carrying:
  some crumbs
  angry fish
  stack of sticky notes
  anime figurine
  rare great hornd bath towl cat
  half-eaten pie
  suspicious rag
  an umbrella

>drop pie
Dropped.

>take key
Taken.

>look
Cluttered Room
A room, half the size of the previous room, filled to the brim with chairs, folded tables, closed crates, and smaller tidbits scattered about.

To the south, almost obscured behind a large gray couch, you see a closed door.

To your left you see a dented bucket. Or maybe it's important items for progressing in the game.

The couch lying in front of the door sags with (fake) age, and it's got tears in the tattered fabric in some places.

You can also see half-eaten pie and skull here.

>open door with key
You unlock the first door.

>go through first door
(first opening the first door)

Maze
You land in the next room just beyond the exit of the hallway, and the ground rumbles as it collapses behind you. You find yourself in what seems to be an ancient cobblestone maze. Rocks here and there seem to have fallen out of the wall over the ages it has stood in place, creating fist-sized holes in the walls. The path extends out to the east and west to either side. To the east you see a hallway continuing into the next room.

On the wall is a giant sign that says "PUZZLE INOPERABLE."

To the south, almost obscured behind a large gray couch, you see a closed door.

* * *

>x bucket
A medium-sized tin bucket, paint peeling from use. Or probably not, because this world doesn't really exist and I made it up.

In the bucket are an umbrella, a skull, a suspicious rag, a half-eaten pie, a rare great hornd bath towl cat, an anime figurine, a stack of sticky notes and the angry fish.

>x angry fish
The angriest fish you've ever seen. It's not in any bag or water, which might explain its mood.

>x fish
The angriest fish you've ever seen. It's not in any bag or water, which might explain its mood.

>x happy fish
The angriest fish you've ever seen. It's not in any bag or water, which might explain its mood.

* * *

>x bucket
A medium-sized tin bucket, paint peeling from use. Or probably not, because this world doesn't really exist and I made it up.

In the bucket are an umbrella, a skull, a suspicious rag, a half-eaten pie, a rare great hornd bath towl cat, an anime figurine, a stack of sticky notes and the angry fish.

>x umbrella
A blue-and-white umbrella with a worn wooden handle. One of the spokes is bent inwards, because the umbrella is bad and I want you to have bad things.

>x skill
You can't see any such thing.

>x skull
A skull bleached white from all the time I spent making it up. It looks a lot like yours would normally.

* * *

>x umbrella
A blue-and-white umbrella with a worn wooden handle. One of the spokes is bent inwards, because the umbrella is bad and I want you to have bad things.

>x skull
A skull bleached white from all the time I spent making it up. It looks a lot like yours would normally.

>x suspicious rag
A very suspicious rag. It's unusual, questionable, and maybe even dubious. It's also gray and the tag says "Dry Erase Cleaning Cloth." How odd.

>x half-eaten pie
Half of an apple pie, clearly eaten without silverware as if it was a snack. I must have left this here accidentally.

>x  rare great hornd bath towl cat
Kind of self explanatory.

>x anime figurine
A Goku figurine. You look closer, and it punches you in the face.

>x stack of sticky notes
A stack of yellow sticky notes with a list of items (milk, eggs, and bread if you must know). It looks suspiciously like the icon for the Sticky Notes app on macOS Big Sur because that's what it is.

>x angry fish
The angriest fish you've ever seen. It's not in any bag or water, because it's not real.

* * *

>x chouch
You can't see any such thing.

>x couch
On closer inspection, you realize only the lower couch is real and the other one is inconsequential.

In the couch are some crumbs and a gate key.

* * *

>x couch
On closer inspection, you realize that's it your couch. I stole it from the real world to put in my game.

>look
Cluttered Room
A room, half the size of the previous room, filled to the brim with chairs, folded tables, closed crates, and smaller tidbits: rolled-up newspapers, stacks of loose paper, broken electronics, a Peloton, watches in a display case, a lamp, pots and pans, and other bits such items scattered about. To the south, almost obscured behind a large gray couch, you see door.

To your left you see a dented bucket overflowing with junk. Or maybe it's important items for progressing in the game.

The couch lying in front of the door sags with (fake) age, and it's got tears in the tattered fabric in some places.

* * *

>x couch
On closer inspection, you realize that's it your couch. I stole it from the real world to put in my game.

>look in couch
In the couch are some crumbs and a gate key.

* * *

>search couch
You search under the couch and under the cushions, and find a small key hiding underneath.

>x couch
On closer inspection, you realize that's it your couch. I stole it from the real world to put in my game.

In the couch is a first key.

* * *

>search couch
You look through the couch, and find nothing. I made the couch bigger on the inside than the outside, so it's extra hard to find anything hiding inside.

>take crumbs
Taken.

* * *

>take key
You already have that.

>search couch
You look through the couch, and find nothing. I made the couch bigger on the inside than the outside, so it's extra hard to find anything hiding inside.

* * *

>take key
Taken.

>x key
A small silver key emblazoned with the English letter "U."

>search couch
You search under the couch and under the cushions, and find a small key hiding underneath.

>i
You are carrying nothing.

* * *

>x couch
On closer inspection, you realize that's it your couch. I stole it from the real world to put in my game.

>x couchs
You can't see any such thing.

>x chouch
You can't see any such thing.

>x couches
You can't see any such thing.

>x chouch
You can't see any such thing.

* * *

>x door
A square door made of metal. It's printed from a bunch of smaller metal squares, almost like a chocolate bar. Like the door from the first room, it's painted a deep blue laced with white and yellow veins. I like that kind of door.

>open door
It seems to be locked.

>unlock door
What do you want to unlock the first door with?

>i
You are carrying nothing.

* * *

>x door
A square door made of metal. It's printed from a bunch of smaller metal squares, almost like a chocolate bar. Like the door from the first room, it's painted a deep blue laced with white and yellow veins. I like that kind of door.

>x bucket
A medium-sized tin bucket, paint peeling from use. Or probably not, because this world doesn't really exist and I made it up.

In the bucket are an umbrella, skull, suspicious rag, half-eaten pie, rare great hornd bath towl cat, anime figurine, stack of sticky notes and angry fish.

>x umbrella
A blue-and-white umbrella with a worn wooden handle. One of the spokes is bent inwards, because the umbrella is bad and I want you to have bad things.

* * *

>x skull
A skull bleached white from all the time I spent making it up. It looks a lot like yours would normally.

>x rag
A very suspicious rag. It's unusual, questionable, and maybe even dubious. It's also gray and the tag says "Dry Erase Cleaning Cloth." How odd.

>x pie
Half of an apple pie, clearly eaten without silverware as if it was a snack. I must have left this here accidentally.

>x cat
Kind of self explanatory.

>x figurine
A Goku figurine. You look closer, and it punches you in the face.

>x notes
A stack of yellow sticky notes with a list of items (milk, eggs, and bread if you must know). It looks suspiciously like the icon for the Sticky Notes app on macOS Big Sur because that's what it is.

>x fish
The angriest fish you've ever seen. It's not in any bag or water, because it's not real.

>take umbrella
Taken.

* * *

>take rag
Taken.

>take pie and cat and figurine and notes and fish
half-eaten pie: Taken.
rare great hornd bath towl cat: Taken.
anime figurine: Taken.
stack of sticky notes: Taken.
angry fish: Taken.

>i
You are carrying:
  angry fish
  stack of sticky notes
  anime figurine
  rare great hornd bath towl cat
  half-eaten pie
  suspicious rag
  skull
  an umbrella

>look
Cluttered Room
A room, half the size of the previous room, filled to the brim with chairs, folded tables, closed crates, and smaller tidbits scattered about.

To the south, almost obscured behind a large gray couch, you see a closed door.

To your left you see a dented bucket overflowing with junk. Or maybe it's important items for progressing in the game.

The couch lying in front of the door sags with (fake) age, and it's got tears in the tattered fabric in some places.

>x bucket
A medium-sized tin bucket, paint peeling from use. Or probably not, because this world doesn't really exist and I made it up.

* * *

>x newspaper
You see nothing special about the newspaper.

>take newspaper
That's hardly portable.

* * *

>x object-one
You see nothing special about object-one.

>take object-one
That's hardly portable.

* * *

>x skull
A skull bleached white from all the time I spent making it up. It looks a lot like yours would normally.

* * *

>x stack of sticky notes
A stack of yellow sticky notes with a list of items (milk, eggs, and bread if you must know). It looks suspiciously like the icon for the Sticky Notes app on macOS Big Sur because that's what it is.

>x bucket
A medium-sized tin bucket, paint peeling from use. Or probably not, because this world doesn't really exist and I made it up.

In the bucket are an umbrella, a skull and a stack of sticky notes.

* * *

>x umbrella
A blue-and-white umbrella with a worn wooden handle. One of the spokes is bent inwards, because the umbrella is bad and I want you to have bad things.

>x bucket
A medium-sized tin bucket, paint peeling from use. Or probably not, because this world doesn't really exist and I made it up.

In the bucket is an umbrella.

* * *

>w / s
I only understood you as far as wanting to (go) w.

>w \ s
I only understood you as far as wanting to (go) w.

>nw
You can't go that way.

>n
You can't go that way.

* * *

>s
You can't go that way.

>w
Cluttered Room

>s
The Hedge Maze

* * *

>win
Ok.

    *** The End ***

Would you like to RESTART, RESTORE a saved game, QUIT or UNDO the last command?

* * *

>x blue door
A small blue door leads south. In the Middle Eastern style, the top of the door is a semicircle.

>x metal door
Taking a closer look at the door, you see the flakes of paint chipping off with age, little smudges where the painter's brush slipped, a little mark of their humanity. Unless, actually, they're not human - given that this is a dimension dreamed up by a vengeful wizard.

>x hallway
Looking closer, you see it's a hallway. Dipstick.

>w
Cluttered Room
You pass through the stone hallway, and step out in to the most cluttered room you've ever seen. You spin around, and bump into a tall stack of chairs like a moron.

You find yourself in a room, half the size of the previous room, filled to the brim with chairs, folded tables, closed crates, and smaller tidbits scattered about.

Behind you to the east you see a hallway, hewn out of the stone, leading  to another room.

To the south, almost obscured behind a large gray couch, you see a door.

To your right you see a dented bucket overflowing with junk. Or maybe it's important items for progressing in the game.

The couch, lying to your left in front of the door, sags with (fake) age, and it's got tears in the tattered fabric in some places.

* * *

>take key and crumbs and fish
first key: Taken.
crumbs: Taken.
angry fish: Taken.

>feed the fish crumbs
The fish, though hesitant at first, wolfs down the crumbs in a matter of seconds and wiggles happily. I'm sure it would be inclined to help you out if you ever needed anything fish-related.

>unlock door with first key
You unlock the first door.

>s
(first opening the first door)

Cobble Wall
You push through the door, and find yourself in a tiny room. To your left a cobblestone wall stretches up high above, ending just before the ceiling. Rocks here and there seem to have fallen out of the wall over the ages it has stood in place, creating holes of varying sizes throughout the surface.

To the north you can see the door you came through earlier.

In the center of the wall to the east, you can see a hole as average as yourself. It's so normal it's disappointing.

To the southeast, you can see a miniscule hole, barely larger than your average United State dime, a ten-cent coin, one tenth of a United States dollar, labeled formally as "one dime". The denomination was first authorized by the Coinage Act of 1792. The dime is the smallest in diameter and is the thinnest of all U.S. coins currently minted for circulation, being 0.705 inches (17.91 millimeters) in diameter and 0.053 in (1.35 mm) in thickness. The hole is that size.

To the northeast, you see a hole roughly the size of a fist, punched through the rock in a feat of strength, possibly in frustration, possibly with this game.

* * *

>n
(first opening the small blue door)

Great Room
A grand room built from giant blocks of a sand-colored stone, stacked up to a ceiling high above where a massive compass lays embedded in the rock.

To the south, a small blue door is embedded in the rock.

Behind you to the west you see a hallway, hewn out of the stone, leading  to another room.

Before you to the east, taking up almost the entire wall, is a great metal door painted a deep blue and patterned with yellow and white veins that run throughout. At the base of the door are four keyholes and four doorknobs.

>unlock metal door
What do you want to unlock Final Door with?

>unlock metal door with keys
You can't use multiple objects with that verb.

* * *

>x blue door
A small blue door leads south. In the Middle Eastern style, the top of the door is a semicircle.

>x small blue door
A small blue door leads south.

>w
Cluttered Room
You pass through the stone hallway, and step out in to the most cluttered room you've ever seen. You spin around, and bump into a tall stack of chairs like a moron.

You find yourself in a room, half the size of the previous room, filled to the brim with chairs, folded tables, closed crates, and smaller tidbits scattered about.

Behind you to the east you see a hallway, hewn out of the stone, leading  to another room.

To the south, almost obscured behind a large gray couch, you see a door.

To your right you see a dented bucket overflowing with junk. Or maybe it's important items for progressing in the game.

The couch, lying to your left in front of the door, sags with (fake) age, and it's got tears in the tattered fabric in some places.

>search couch
You search under the couch and under the cushions, and find a small key hiding underneath.

Though you've never been the best finder-of-things, particularly due to your atrocious eyesight and generally dreadful searching ability, you think the couch has the first key.

>take key and pie and fish
first key: Taken.
half-eaten pie: Taken.
angry fish: Taken.

* * *

>set lock to 594.46
The dial clicks as you set the number.

>set lock to 594.56
The safe lid pops open with a rush of air as the seal is broken. Inside, you see the third key.

* * *

>feed fish the pie
(the angry fish the half-eaten pie)
The fish, though hesitant at first, wolfs down the half-eaten pie in a matter of seconds and wiggles happily. I'm sure it would be inclined to help you out if you ever needed anything fish-related.

>put fish in tank
(the happy fish in the fish tank)
You reach above the glass lip with a tentacle and drop the fish into the water. It gives you a little wink and dives to the bottom of the tank, dissappearing into the reef. A few seconds later, a pair of keys fly out of the water and hit you square between the eyes.

* * *

>unlock door with fourth key
Which do you mean, the fourth door or the third door?

>unlock fourth door with fourth key
You unlock the fourth door.

>n
(first opening the fourth door)

Great Room
A grand room built from giant blocks of a sand-colored stone, stacked up to a ceiling high above where a massive compass lays embedded in the rock.

To the south, a small blue door is embedded in the rock.

Behind you to the west you see a hallway, hewn out of the stone, leading  to another room.

Before you to the east, taking up almost the entire wall, is a great metal door painted a deep blue and patterned with yellow and white veins that run throughout. At the base of the door are four keyholes and four doorknobs.

* * *

>x blue door
A small blue door leads south. In the Middle Eastern style, the top of the door is a semicircle.

>x small door
A small blue door leads south. In the Middle Eastern style, the top of the door is a semicircle.

>x small blue door
A small blue door leads south. In the Middle Eastern style, the top of the door is a semicircle.

* * *

>x door
Which do you mean, the fourth door or Final Door?

>x fourth door
A small blue door leads south.

>s
(first opening the fourth door)
It seems to be locked.

* * *

>x first keyhole
First keyhole is empty.

* * *

>x first knob
You see nothing special about the first doorknob.

>x first door knob
You see nothing special about the first doorknob.

>turn first doorknob
You turn the first doorknob, and nothing happens. You don't appear to be able to turn this doorknob by itself.

>turn first knob
You turn the first doorknob, and nothing happens. You don't appear to be able to turn this doorknob by itself.

* * *

>x fuck
You see nothing special about Fuck.

* * *

>x hallway
Looking closer, you see it's a hallway. Dipstick.

>x door
Taking a closer look at the door, you see the flakes of paint chipping off with age, little smudges where the painter's brush slipped, a little mark of their humanity. Unless, actually, they're not human - given that this is a dimension dreamed up by a vengeful wizard

>look
Great Room
A grand room built from giant blocks of a sand-colored stone, stacked up to a ceiling high above where a massive compass lays embedded in the rock.

Back to the west you see a hallway, hewn out of the stone, leading to another room.

Before you to the east, taking up almost the entire wall, is a great metal door painted a deep blue and patterned with yellow and white veins that run throughout. At the base of the door are eight large keyholes.

>w
Cluttered Room
You pass through the stone hallway, and step out in to the most cluttered room you've ever seen. You spin around, and bump into a tall stack of chairs like a big moron.

You find yourself in a room, half the size of the previous room, filled to the brim with chairs, folded tables, closed crates, and smaller tidbits scattered about.

Back to the west you see a hallway, hewn out of the stone, leading to another room.

To the south, almost obscured behind a large gray couch, you see a closed door.

To your left you see a dented bucket overflowing with junk. Or maybe it's important items for progressing in the game.

The couch lying in front of the door sags with (fake) age, and it's got tears in the tattered fabric in some places.

>e
Great Room
A grand room built from giant blocks of a sand-colored stone, stacked up to a ceiling high above where a massive compass lays embedded in the rock.

Back to the west you see a hallway, hewn out of the stone, leading to another room.

Before you to the east, taking up almost the entire wall, is a great metal door painted a deep blue and patterned with yellow and white veins that run throughout. At the base of the door are eight large keyholes.

* * *

>x hidden utilities
A container used to prevent doorknobs and keyholes from showing up. Props to you for finding it, but it's pretty useless.

>turn the first doorknob
You can't see any such thing.

>turn the first knob
It is fixed in place.

* * *

>x metal door
Taking a closer look at the door, you see the flakes of paint chipping off with age, little smudges where the painter's brush slipped, a little mark of their humanity. Unless, actually, they're not human - given that this is a dimension dreamed up by a vengeful wizard. You're going to need to use... something, if you want to actually unlock this door - between you and me, you have to turn all these things at once to actually get it open.

>x great door
Taking a closer look at the door, you see the flakes of paint chipping off with age, little smudges where the painter's brush slipped, a little mark of their humanity. Unless, actually, they're not human - given that this is a dimension dreamed up by a vengeful wizard. You're going to need to use... something, if you want to actually unlock this door - between you and me, you have to turn all these things at once to actually get it open.

* * *

>x penis
You see nothing special about the penis.

>take penis
That's hardly portable.

* * *

>x w
You see nothing unexpected in that direction.

>w
Cluttered Room
You pass through the stone hallway, and step out in to the most cluttered room you've ever seen. You spin around, and bump into a tall stack of chairs. A snicker echoes from above, and you're reminded about how stupid this situation is.

You find yourself in a room, half the size of the previous room, filled to the brim with chairs, folded tables, closed crates, and smaller tidbits: rolled-up newspapers, stacks of loose paper, broken electronics, a Peloton, watches in a display case, a lamp, pots and pans, and other bits such items scattered about. To the south, almost obscured behind two stacked couches, you see door.

To your left you see a dented bucket overflowing with junk. Or maybe it's important items for progressing in the game.

>x bucket
A medium-sized tin bucket, paint peeling from use. Or probably not, because this world doesn't really exist and I made it up.

In the bucket are an umbrella, skull, stack of sticky notes and a suspicious rag.

>x umbrella
A blue-and-white umbrella with a worn wooden handle. One of the spokes is bent inwards, because the umbrella is bad and I want you to have bad things.

* * *

>x skull
A skull bleached white from all the time I spent making it up. It looks a lot like yours would normally.

>x stack of sticky notes
A stack of yellow sticky notes with a list of items (milk, eggs, and bread if you must know). It looks suspiciously like the icon for the Sticky Notes app on macOS Big Sur because that's what it is.

>x suspicious rag
A very suspicious rag. It's unusual, questionable, and maybe even dubious. It's also gray and the tag says "Dry Erase Cleaning Cloth." How odd.